"","...1","School List","ST Hispanic","ST Native American","ST Asian","ST Black","ST Hawaiian or Other Pacific Islander","ST Two or more races","ST Total Bipoc","ST Total White","ST Total Men","ST Total Women","ST Total AGI","ST Total","ST BIPOC Men","ST BIPOC Women","ST BIPOC AGI","Year"
"1",1,"AKRON, UNIVERSITY OF",11,0,2,12,0,6,31,145,95,81,0,176,18,13,0,2017
"2",2,"ALABAMA, UNIVERSITY OF",8,0,1,13,0,3,25,97,67,55,0,122,15,10,0,2017
"3",3,"ALBANY LAW SCHOOL",10,1,5,9,0,2,27,116,73,70,0,143,11,16,0,2017
"4",4,"AMERICAN UNIVERSITY",81,0,25,24,1,26,157,229,144,242,0,386,53,104,0,2017
"5",5,"APPALACHIAN SCHOOL OF LAW",3,1,3,15,0,0,22,47,31,38,0,69,9,13,0,2017
"6",6,"ARIZONA STATE UNIVERSITY",25,5,11,2,1,8,52,154,111,95,0,206,32,20,0,2017
"7",7,"ARIZONA, UNIVERSITY OF",17,7,6,2,1,1,34,56,42,48,0,90,12,22,0,2017
"8",8,"ARKANSAS, FAYETTEVILLE, UNIVERSITY OF",6,2,3,5,0,8,24,95,67,52,0,119,13,11,0,2017
"9",9,"ARKANSAS, LITTLE ROCK, UNIVERSITY OF",10,4,4,16,0,0,34,132,87,79,0,166,9,25,0,2017
"10",10,"ATLANTA'S JOHN MARSHALL LAW SCHOOL",13,2,1,65,16,0,97,45,48,94,0,142,28,69,0,2017
"11",11,"AVE MARIA SCHOOL OF LAW",24,0,0,6,0,0,30,61,33,58,0,91,7,23,0,2017
"12",12,"BALTIMORE, UNIVERSITY OF",20,3,18,40,0,5,86,149,118,117,0,235,44,42,0,2017
"13",13,"BARRY UNIVERSITY",75,5,11,43,1,0,135,119,107,147,0,254,43,92,0,2017
"14",14,"BAYLOR UNIVERSITY",31,4,12,0,0,5,52,118,86,84,0,170,25,27,0,2017
"15",15,"BELMONT UNIVERSITY",3,0,2,6,0,4,15,94,50,59,0,109,6,9,0,2017
"16",16,"BOSTON COLLEGE",13,1,32,9,0,0,55,179,124,110,0,234,30,25,0,2017
"17",17,"BOSTON UNIVERSITY",21,1,19,8,0,8,57,151,86,122,0,208,19,38,0,2017
"18",18,"BRIGHAM YOUNG UNIVERSITY",7,1,2,1,1,8,20,80,60,40,0,100,12,8,0,2017
"19",19,"BROOKLYN LAW SCHOOL",51,0,40,24,1,9,125,245,179,191,0,370,49,76,0,2017
"20",20,"CALIFORNIA WESTERN SCHOOL OF LAW",30,1,22,12,4,38,107,119,91,135,0,226,39,68,0,2017
"21",21,"CALIFORNIA-BERKELEY, UNIVERSITY OF",45,1,64,8,0,15,133,157,104,186,0,290,44,89,0,2017
"22",22,"CALIFORNIA-DAVIS, UNIVERSITY OF",26,0,20,9,0,15,70,66,57,79,0,136,26,44,0,2017
"23",23,"CALIFORNIA-IRVINE, UNIVERSITY OF",27,0,28,5,0,7,67,71,52,86,0,138,22,45,0,2017
"24",24,"CALIFORNIA-LOS ANGELES, UNIVERSITY OF",27,1,39,11,0,8,86,174,127,133,0,260,32,54,0,2017
"25",25,"CAMPBELL UNIVERSITY",6,0,0,11,0,3,20,144,79,85,0,164,5,15,0,2017
"26",26,"CAPITAL UNIVERSITY",8,1,3,15,0,10,37,123,78,82,0,160,16,21,0,2017
"27",27,"CARDOZO SCHOOL OF LAW",27,0,28,15,0,4,74,230,136,168,0,304,34,40,0,2017
"28",28,"CASE WESTERN RESERVE UNIVERSITY",12,0,4,10,0,1,27,97,50,74,0,124,8,19,0,2017
"29",29,"CATHOLIC UNIVERSITY OF AMERICA",14,1,2,6,0,2,25,69,37,57,0,94,12,13,0,2017
"30",30,"CHAPMAN UNIVERSITY",34,0,21,2,0,14,71,86,61,96,0,157,25,46,0,2017
"31",31,"CHARLESTON SCHOOL OF LAW",22,8,7,48,0,2,87,233,157,163,0,320,34,53,0,2017
"32",32,"CHICAGO, UNIVERSITY OF",25,0,17,9,0,12,63,119,90,92,0,182,27,36,0,2017
"33",33,"CHICAGO-KENT COLLEGE OF LAW-IIT",31,0,19,10,0,12,72,148,117,103,0,220,40,32,0,2017
"34",34,"CINCINNATI, UNIVERSITY OF",5,0,7,5,0,0,17,68,40,45,0,85,7,10,0,2017
"35",35,"CITY UNIVERSITY OF NEW YORK",38,0,19,24,1,5,87,90,76,101,0,177,34,53,0,2017
"36",36,"CLEVELAND STATE UNIVERSITY",4,0,3,7,0,1,15,113,67,61,0,128,6,9,0,2017
"37",37,"COLORADO, UNIVERSITY OF",32,1,6,4,0,11,54,126,88,92,0,180,28,26,0,2017
"38",38,"COLUMBIA UNIVERSITY",33,1,47,43,0,2,126,214,170,170,0,340,50,76,0,2017
"39",39,"CONNECTICUT, UNIVERSITY OF",12,2,13,6,0,1,34,127,86,75,0,161,21,13,0,2017
"40",40,"CORNELL UNIVERSITY",20,0,19,11,1,8,59,99,82,76,0,158,32,27,0,2017
"41",41,"CREIGHTON UNIVERSITY",10,2,5,1,0,7,25,79,66,38,0,104,13,12,0,2017
"42",42,"DAYTON, UNIVERSITY OF",3,1,4,13,0,6,27,66,38,55,0,93,10,17,0,2017
"43",43,"DENVER, UNIVERSITY OF",40,1,14,10,0,11,76,234,135,175,0,310,31,45,0,2017
"44",44,"DEPAUL UNIVERSITY",19,0,9,24,0,13,65,199,110,154,0,264,30,35,0,2017
"45",45,"DETROIT MERCY, UNIVERSITY OF",6,0,4,9,0,3,22,96,64,54,0,118,6,16,0,2017
"46",46,"DISTRICT OF COLUMBIA",15,0,14,53,0,0,82,28,35,75,0,110,25,57,0,2017
"47",47,"DRAKE UNIVERSITY",5,1,0,10,0,2,18,85,54,49,0,103,4,14,0,2017
"48",48,"DREXEL UNIVERSITY",9,0,8,6,0,1,24,118,78,62,2,142,12,11,1,2017
"49",49,"DUKE UNIVERSITY",17,1,22,15,0,1,56,132,110,78,0,188,24,32,0,2017
"50",50,"DUQUESNE UNIVERSITY",6,1,2,3,1,1,14,148,74,88,0,162,7,7,0,2017
"51",51,"ELON UNIVERSITY",4,1,6,18,1,1,31,101,49,83,0,132,9,22,0,2017
"52",52,"EMORY UNIVERSITY",26,0,15,14,0,5,60,144,114,90,0,204,33,27,0,2017
"53",53,"FAULKNER UNIVERSITY",5,0,0,12,0,2,19,54,41,32,0,73,10,9,0,2017
"54",54,"FLORIDA A&M UNIVERSITY",28,0,6,112,2,25,173,78,92,159,0,251,51,122,0,2017
"55",55,"FLORIDA INTERNATIONAL UNIVERSITY",110,2,6,18,0,3,139,83,88,134,0,222,44,95,0,2017
"56",56,"FLORIDA STATE UNIVERSITY",20,0,3,18,0,15,56,121,83,94,0,177,21,35,0,2017
"57",57,"FLORIDA, UNIVERSITY OF",59,1,8,17,0,6,91,188,130,149,0,279,35,56,0,2017
"58",58,"FORDHAM UNIVERSITY",57,0,45,25,0,4,131,284,189,226,0,415,41,90,0,2017
"59",59,"GEORGE MASON UNIVERSITY",10,0,11,2,0,4,27,140,82,85,0,167,12,15,0,2017
"60",60,"GEORGE WASHINGTON UNIVERSITY",5,4,49,54,1,3,116,265,183,197,1,381,47,68,1,2017
"61",61,"GEORGETOWN UNIVERSITY",35,1,47,50,1,8,142,300,195,247,0,442,52,90,0,2017
"62",62,"GEORGIA STATE UNIVERSITY",26,2,25,36,0,9,98,209,151,156,0,307,42,56,0,2017
"63",63,"GEORGIA, UNIVERSITY OF",8,1,14,14,1,0,38,145,93,90,0,183,16,22,0,2017
"64",64,"GOLDEN GATE UNIVERSITY",57,1,22,32,3,12,127,74,74,127,0,201,42,85,0,2017
"65",65,"GONZAGA UNIVERSITY",10,0,3,0,1,8,22,93,56,59,0,115,10,12,0,2017
"66",66,"HARVARD UNIVERSITY",55,1,69,40,1,12,178,279,238,219,0,457,89,89,0,2017
"67",67,"HAWAII, UNIVERSITY OF",7,1,28,1,3,34,74,36,60,50,0,110,38,36,0,2017
"68",68,"HOFSTRA UNIVERSITY",31,2,10,11,1,1,56,141,97,100,0,197,22,34,0,2017
"69",69,"HOUSTON, UNIVERSITY OF",49,3,18,14,0,0,84,134,120,98,0,218,41,43,0,2017
"70",70,"HOWARD UNIVERSITY",5,0,1,119,0,13,138,1,42,97,0,139,42,96,0,2017
"71",71,"IDAHO, UNIVERSITY OF",11,0,0,2,1,5,19,88,57,50,0,107,10,9,0,2017
"72",72,"ILLINOIS, UNIVERSITY OF",12,0,15,6,0,6,39,92,85,46,0,131,24,15,0,2017
"73",73,"INDIANA UNIVERSITY - BLOOMINGTON",8,0,6,9,0,1,24,114,78,60,0,138,16,8,0,2017
"74",74,"INDIANA UNIVERSITY - INDIANAPOLIS",12,0,6,22,0,9,49,246,140,155,0,295,16,33,0,2017
"75",75,"INTER AMERICAN UNIVERSITY OF PUERTO RICO",294,0,1,0,0,0,295,3,107,189,2,298,105,188,2,2017
"76",76,"IOWA, UNIVERSITY OF",8,0,7,9,0,3,27,86,57,56,0,113,11,16,0,2017
"77",77,"KANSAS, UNIVERSITY OF",6,2,5,7,0,1,21,80,50,51,0,101,13,8,0,2017
"78",78,"KENTUCKY, UNIVERSITY OF",7,2,2,7,0,0,18,91,68,41,0,109,8,10,0,2017
"79",79,"LEWIS AND CLARK COLLEGE",20,2,14,2,0,1,39,121,57,103,0,160,12,27,0,2017
"80",80,"LIBERTY UNIVERSITY",3,0,1,6,0,7,17,54,34,37,0,71,9,8,0,2017
"81",81,"LINCOLN MEMORIAL",5,0,4,9,0,13,31,75,52,54,0,106,16,15,0,2017
"82",82,"LOUISIANA STATE UNIVERSITY",16,1,4,24,0,3,48,129,81,96,0,177,21,27,0,2017
"83",83,"LOUISVILLE, UNIVERSITY OF",5,0,8,4,1,0,18,127,77,67,1,145,4,14,0,2017
"84",84,"LOYOLA MARYMOUNT UNIVERSITY-LOS ANGELES",75,0,55,20,0,20,170,221,189,202,0,391,77,93,0,2017
"85",85,"LOYOLA UNIVERSITY-CHICAGO",36,0,10,22,0,20,88,167,93,162,0,255,26,62,0,2017
"86",86,"LOYOLA UNIVERSITY-NEW ORLEANS",35,8,10,49,0,0,102,161,137,126,0,263,51,51,0,2017
"87",87,"MAINE, UNIVERSITY OF",6,3,2,2,0,0,13,70,39,44,0,83,5,8,0,2017
"88",88,"MARQUETTE UNIVERSITY",7,1,4,16,0,10,38,159,100,97,0,197,23,15,0,2017
"89",89,"MARYLAND, UNIVERSITY OF",17,1,19,16,1,7,61,143,98,106,0,204,24,37,0,2017
"90",90,"MCGEORGE SCHOOL OF LAW",32,3,23,8,1,4,71,93,72,92,0,164,30,41,0,2017
"91",91,"MEMPHIS, UNIVERSITY OF",3,3,1,27,0,0,34,79,64,49,0,113,9,25,0,2017
"92",92,"MERCER UNIVERSITY",10,0,2,14,0,0,26,86,51,61,0,112,8,18,0,2017
"93",93,"MIAMI, UNIVERSITY OF",129,1,9,24,0,14,177,166,180,163,0,343,91,86,0,2017
"94",94,"MICHIGAN STATE UNIVERSITY",16,2,10,16,0,17,61,190,120,131,0,251,26,35,0,2017
"95",95,"MICHIGAN, UNIVERSITY OF",15,1,21,15,0,16,68,232,162,138,0,300,27,41,0,2017
"96",96,"MINNESOTA, UNIVERSITY OF",8,1,15,1,0,6,31,143,89,85,0,174,13,18,0,2017
"97",97,"MISSISSIPPI COLLEGE",5,0,2,18,0,6,31,86,61,56,0,117,10,21,0,2017
"98",98,"MISSISSIPPI, UNIVERSITY OF",13,0,2,19,0,4,38,76,61,53,0,114,21,17,0,2017
"99",99,"MISSOURI, UNIVERSITY OF",6,0,1,7,0,3,17,74,52,39,0,91,9,8,0,2017
"100",100,"MISSOURI-KANSAS CITY, UNIVERSITY OF",7,0,3,7,0,4,21,105,66,60,0,126,13,8,0,2017
"101",101,"MITCHELL | HAMLINE",40,11,25,53,0,13,142,366,249,258,1,508,63,79,0,2017
"102",102,"MONTANA, UNIVERSITY OF",1,5,1,0,0,0,7,63,40,30,0,70,4,3,0,2017
"103",103,"NEBRASKA, UNIVERSITY OF",7,1,0,1,0,0,9,123,79,53,0,132,6,3,0,2017
"104",104,"NEW ENGLAND LAW | BOSTON",28,0,13,19,0,7,67,137,83,121,0,204,23,44,0,2017
"105",105,"NEW HAMPSHIRE, UNIVERSITY OF",3,0,3,0,0,1,7,65,35,37,0,72,3,4,0,2017
"106",106,"NEW MEXICO, UNIVERSITY OF",21,6,2,5,1,22,57,53,51,59,0,110,24,33,0,2017
"107",107,"NEW YORK LAW SCHOOL",70,1,38,23,1,8,141,270,162,249,0,411,45,96,0,2017
"108",108,"NEW YORK UNIVERSITY",39,0,40,30,0,15,124,251,175,200,0,375,54,70,0,2017
"109",109,"NORTH CAROLINA CENTRAL UNIVERSITY",15,6,2,104,0,0,127,56,70,113,0,183,45,82,0,2017
"110",110,"NORTH CAROLINA, UNIVERSITY OF",21,2,9,11,1,10,54,144,91,107,0,198,24,30,0,2017
"111",111,"NORTH DAKOTA, UNIVERSITY OF",4,0,0,1,0,0,5,58,41,22,0,63,5,0,0,2017
"112",112,"NORTHEASTERN UNIVERSITY SCHOOL OF LAW",21,1,26,13,1,10,72,124,70,125,1,196,22,50,0,2017
"113",113,"NORTHERN ILLINOIS UNIVERSITY",11,0,4,12,0,7,34,69,61,42,0,103,23,11,0,2017
"114",114,"NORTHERN KENTUCKY UNIVERSITY",8,0,2,20,0,0,30,207,111,126,0,237,9,21,0,2017
"115",115,"NORTHWESTERN UNIVERSITY",28,0,22,14,0,11,75,124,99,100,0,199,34,41,0,2017
"116",116,"NOTRE DAME, UNIVERSITY OF",18,0,14,11,0,11,54,130,103,81,0,184,28,26,0,2017
"117",117,"NOVA SOUTHEASTERN UNIVERSITY",104,0,12,25,1,9,151,109,115,145,0,260,55,96,0,2017
"118",118,"OHIO NORTHERN UNIVERSITY",3,0,2,4,0,0,9,42,25,26,0,51,4,5,0,2017
"119",119,"OHIO STATE UNIVERSITY",14,0,11,12,0,9,46,159,125,80,0,205,25,21,0,2017
"120",120,"OKLAHOMA CITY UNIVERSITY",15,15,10,13,0,17,70,84,64,90,0,154,23,47,0,2017
"121",121,"OKLAHOMA, UNIVERSITY OF",7,8,3,7,0,15,40,114,84,70,0,154,23,17,0,2017
"122",122,"OREGON, UNIVERSITY OF",13,0,3,3,0,9,28,106,61,73,0,134,15,13,0,2017
"123",123,"PACE UNIVERSITY",16,1,7,10,1,12,47,125,73,99,0,172,14,33,0,2017
"124",124,"PENNSYLVANIA STATE - DICKINSON LAW",7,0,3,0,0,4,14,52,41,25,0,66,7,7,0,2017
"125",125,"PENNSYLVANIA STATE - PENN STATE LAW",4,0,4,14,0,6,28,85,55,58,0,113,15,13,0,2017
"126",126,"PENNSYLVANIA, UNIVERSITY OF",18,0,22,15,0,14,69,139,105,103,0,208,27,42,0,2017
"127",127,"PEPPERDINE UNIVERSITY",22,1,7,4,0,7,41,97,69,69,0,138,17,24,0,2017
"128",128,"PITTSBURGH, UNIVERSITY OF",7,0,9,11,0,5,32,94,62,63,1,126,16,15,1,2017
"129",129,"PONTIFICAL CATHOLIC UNIVERSITY OF P.R.",170,0,0,0,0,0,170,0,64,106,0,170,64,106,0,2017
"130",130,"PUERTO RICO, UNIVERSITY OF",301,0,0,0,0,16,317,0,135,182,0,317,135,182,0,2017
"131",131,"QUINNIPIAC UNIVERSITY",14,0,3,3,0,0,20,99,48,71,0,119,6,14,0,2017
"132",132,"REGENT UNIVERSITY",14,1,3,11,0,3,32,66,41,57,0,98,10,22,0,2017
"133",133,"RICHMOND, UNIVERSITY OF",0,1,5,12,0,6,24,80,45,59,0,104,10,14,0,2017
"134",134,"ROGER WILLIAMS UNIVERSITY",22,0,3,15,0,8,48,108,72,84,0,156,21,27,0,2017
"135",135,"RUTGERS UNIVERSITY",56,1,31,44,0,0,132,233,185,180,0,365,50,82,0,2017
"136",136,"SAINT LOUIS UNIVERSITY",13,1,5,21,0,8,48,141,89,100,0,189,21,27,0,2017
"137",137,"SAMFORD UNIVERSITY",5,3,1,13,0,0,22,130,76,76,0,152,7,15,0,2017
"138",138,"SAN DIEGO, UNIVERSITY OF",34,6,30,13,1,2,86,165,105,146,0,251,29,57,0,2017
"139",139,"SAN FRANCISCO, UNIVERSITY OF",33,1,15,8,3,12,72,63,62,73,0,135,34,38,0,2017
"140",140,"SANTA CLARA UNIVERSITY",65,1,58,6,0,15,145,96,95,146,0,241,51,94,0,2017
"141",141,"SEATTLE UNIVERSITY",26,0,19,11,2,21,79,113,89,103,0,192,33,46,0,2017
"142",142,"SETON HALL UNIVERSITY",47,0,17,16,0,7,87,169,123,133,0,256,27,60,0,2017
"143",143,"SOUTH CAROLINA, UNIVERSITY OF",11,0,4,17,0,11,43,170,116,97,0,213,18,25,0,2017
"144",144,"SOUTH DAKOTA, UNIVERSITY OF",1,0,0,0,1,3,5,49,33,21,0,54,4,1,0,2017
"145",145,"SOUTH TEXAS COLLEGE OF LAW HOUSTON",147,2,38,45,0,9,241,214,227,228,0,455,104,137,0,2017
"146",146,"SOUTHERN CALIFORNIA, UNIVERSITY OF",19,0,35,15,0,13,82,98,100,80,0,180,44,38,0,2017
"147",147,"SOUTHERN ILLINOIS UNIVERSITY-CARBONDALE",3,0,3,8,0,7,21,91,56,56,0,112,9,12,0,2017
"148",148,"SOUTHERN METHODIST UNIVERSITY",27,0,9,5,0,10,51,149,100,100,0,200,25,26,0,2017
"149",149,"SOUTHERN UNIVERSITY",2,1,5,140,0,11,159,92,101,150,0,251,46,113,0,2017
"150",150,"SOUTHWESTERN LAW SCHOOL",96,0,31,23,1,14,165,191,153,203,0,356,62,103,0,2017
"151",151,"ST. JOHN'S UNIVERSITY",22,0,17,21,0,5,65,183,136,112,0,248,25,40,0,2017
"152",152,"ST. MARY'S UNIVERSITY",155,6,10,18,1,0,190,130,163,157,0,320,100,90,0,2017
"153",153,"ST. THOMAS UNIVERSITY (FLORIDA)",142,0,8,13,0,9,172,38,88,122,0,210,69,103,0,2017
"154",154,"ST. THOMAS, UNIVERSITY OF (MINNESOTA)",9,1,4,7,0,4,25,126,69,82,0,151,7,18,0,2017
"155",155,"STANFORD UNIVERSITY",25,0,17,11,0,12,65,106,93,78,0,171,31,34,0,2017
"156",156,"STETSON UNIVERSITY",58,1,12,24,0,18,113,319,215,217,0,432,49,64,0,2017
"157",157,"SUFFOLK UNIVERSITY",29,1,24,13,2,7,76,323,185,213,1,399,30,45,1,2017
"158",158,"SYRACUSE UNIVERSITY",16,0,6,22,0,8,52,143,103,92,0,195,27,25,0,2017
"159",159,"TEMPLE UNIVERSITY",24,1,20,23,0,1,69,189,123,134,1,258,31,38,0,2017
"160",160,"TENNESSEE, UNIVERSITY OF",8,1,1,9,0,8,27,91,59,59,0,118,14,13,0,2017
"161",161,"TEXAS A&M UNIVERSITY",28,2,1,11,0,0,42,98,71,69,0,140,21,21,0,2017
"162",162,"TEXAS AT AUSTIN, UNIVERSITY OF",43,1,19,14,0,12,89,202,148,143,0,291,35,54,0,2017
"163",163,"TEXAS SOUTHERN UNIVERSITY THURGOOD MARSHALL SCHOOL OF LAW",67,3,5,161,0,3,239,15,98,156,0,254,90,149,0,2017
"164",164,"TEXAS TECH UNIVERSITY",12,1,2,5,0,20,40,99,83,56,0,139,17,23,0,2017
"165",165,"TOLEDO, UNIVERSITY OF",3,0,2,7,1,0,13,89,54,48,0,102,7,6,0,2017
"166",166,"TOURO UNIVERSITY",12,0,20,24,0,11,67,94,81,80,0,161,26,41,0,2017
"167",167,"TULANE UNIVERSITY",13,0,6,15,0,5,39,159,87,111,0,198,16,23,0,2017
"168",168,"TULSA, UNIVERSITY OF",2,7,0,4,0,14,27,70,55,42,0,97,17,10,0,2017
"169",169,"UNIVERSITY OF BUFFALO-SUNY",2,1,7,8,0,4,22,114,59,77,0,136,6,16,0,2017
"170",170,"UNIVERSITY OF CALIFORNIA COLLEGE OF THE LAW, SAN FRANCISCO",45,8,68,6,1,0,128,160,135,152,1,288,53,75,0,2017
"171",171,"UNIVERSITY OF ILLINOIS CHICAGO SCHOOL OF LAW",60,1,16,52,0,8,137,187,143,175,6,324,51,81,5,2017
"172",172,"UNIVERSITY OF MASSACHUSETTS DARTMOUTH",11,0,5,10,0,4,30,64,48,46,0,94,13,17,0,2017
"173",173,"UNIVERSITY OF NEVADA - LAS VEGAS",27,0,5,6,0,6,44,61,45,60,0,105,18,26,0,2017
"174",174,"UTAH, UNIVERSITY OF",1,2,2,0,1,4,10,75,46,39,0,85,2,8,0,2017
"175",175,"VANDERBILT UNIVERSITY",15,1,19,13,1,0,49,105,73,81,0,154,25,24,0,2017
"176",176,"VERMONT LAW SCHOOL",14,0,6,9,0,5,34,109,70,73,0,143,17,17,0,2017
"177",177,"VILLANOVA UNIVERSITY",13,0,7,12,0,6,38,133,78,93,0,171,13,25,0,2017
"178",178,"VIRGINIA, UNIVERSITY OF",18,0,13,19,1,16,67,240,162,145,0,307,31,36,0,2017
"179",179,"WAKE FOREST UNIVERSITY",13,0,5,14,0,5,37,115,75,77,0,152,18,19,0,2017
"180",180,"WASHBURN UNIVERSITY",6,0,6,4,0,8,24,85,66,43,0,109,13,11,0,2017
"181",181,"WASHINGTON AND LEE UNIVERSITY",5,1,12,9,1,1,29,96,59,66,0,125,15,14,0,2017
"182",182,"WASHINGTON UNIVERSITY",17,2,13,30,0,6,68,149,98,119,0,217,27,41,0,2017
"183",183,"WASHINGTON, UNIVERSITY OF",7,1,20,4,0,10,42,104,73,73,0,146,20,22,0,2017
"184",184,"WAYNE STATE UNIVERSITY",6,1,4,15,0,5,31,125,83,73,0,156,14,17,0,2017
"185",185,"WEST VIRGINIA UNIVERSITY",5,0,1,4,0,2,12,97,54,55,0,109,6,6,0,2017
"186",186,"COOLEY LAW SCHOOL",31,2,20,146,1,88,288,277,243,321,1,565,101,187,0,2017
"187",187,"WESTERN NEW ENGLAND UNIVERSITY",10,1,7,12,0,1,31,56,32,55,0,87,6,25,0,2017
"188",188,"WESTERN STATE COLLEGE OF LAW",58,1,31,12,1,10,113,79,95,97,0,192,50,63,0,2017
"189",189,"WIDENER UNIVERSITY-DELAWARE",19,5,12,31,0,3,70,224,151,143,0,294,33,37,0,2017
"190",190,"WIDENER-COMMONWEALTH",17,2,4,21,0,0,44,110,73,81,0,154,16,28,0,2017
"191",191,"WILLAMETTE UNIVERSITY",14,1,6,3,1,5,30,76,52,54,0,106,15,15,0,2017
"192",192,"WILLIAM AND MARY LAW SCHOOL",6,0,9,10,0,4,29,142,75,96,0,171,10,19,0,2017
"193",193,"WISCONSIN, UNIVERSITY OF",17,1,3,9,0,2,32,126,91,67,0,158,12,20,0,2017
"194",194,"WYOMING, UNIVERSITY OF",2,2,1,0,0,0,5,66,40,31,0,71,3,2,0,2017
"195",195,"YALE UNIVERSITY",26,0,27,15,0,13,81,103,84,100,0,184,28,53,0,2017
"196",196,"AKRON, UNIVERSITY OF",2,0,9,10,0,11,32,115,79,68,0,147,15,17,0,2018
"197",197,"ALABAMA, UNIVERSITY OF",6,1,1,12,0,3,23,89,59,53,0,112,13,10,0,2018
"198",198,"ALBANY LAW SCHOOL",16,0,9,10,0,5,40,144,85,99,0,184,19,21,0,2018
"199",199,"AMERICAN UNIVERSITY",60,1,31,32,0,24,148,281,181,248,0,429,55,93,0,2018
"200",200,"APPALACHIAN SCHOOL OF LAW",3,5,5,3,0,0,16,46,27,35,0,62,7,9,0,2018
"201",201,"ARIZONA STATE UNIVERSITY",25,5,12,4,0,5,51,196,128,119,0,247,23,28,0,2018
"202",202,"ARIZONA, UNIVERSITY OF",22,4,1,2,2,6,37,77,64,48,2,114,18,19,0,2018
"203",203,"ARKANSAS, FAYETTEVILLE, UNIVERSITY OF",5,2,1,8,0,6,22,104,67,59,0,126,12,10,0,2018
"204",204,"ARKANSAS, LITTLE ROCK, UNIVERSITY OF",9,5,3,12,0,0,29,103,67,65,0,132,11,18,0,2018
"205",205,"ATLANTA'S JOHN MARSHALL LAW SCHOOL",9,1,1,36,21,0,68,63,60,71,0,131,25,43,0,2018
"206",206,"AVE MARIA SCHOOL OF LAW",19,0,2,9,0,0,30,62,43,49,0,92,13,17,0,2018
"207",207,"BALTIMORE, UNIVERSITY OF",20,1,25,43,0,18,107,158,119,146,0,265,41,66,0,2018
"208",208,"BARRY UNIVERSITY",65,2,10,41,1,0,119,124,102,141,0,243,50,69,0,2018
"209",209,"BAYLOR UNIVERSITY",20,3,4,5,0,4,36,136,93,79,0,172,21,15,0,2018
"210",210,"BELMONT UNIVERSITY",11,0,2,3,0,4,20,84,38,66,0,104,5,15,0,2018
"211",211,"BOSTON COLLEGE",3,0,17,5,0,19,44,164,102,106,0,208,18,26,0,2018
"212",212,"BOSTON UNIVERSITY",41,0,16,16,0,12,85,174,92,167,0,259,18,67,0,2018
"213",213,"BRIGHAM YOUNG UNIVERSITY",12,1,2,1,2,1,19,74,46,47,0,93,10,9,0,2018
"214",214,"BROOKLYN LAW SCHOOL",33,1,29,10,0,12,85,229,131,183,0,314,28,57,0,2018
"215",215,"CALIFORNIA WESTERN SCHOOL OF LAW",41,0,13,12,5,35,106,112,89,129,0,218,36,70,0,2018
"216",216,"CALIFORNIA-BERKELEY, UNIVERSITY OF",36,1,57,13,0,25,132,155,116,171,0,287,60,72,0,2018
"217",217,"CALIFORNIA-DAVIS, UNIVERSITY OF",39,0,40,3,0,17,99,98,82,115,0,197,41,58,0,2018
"218",218,"CALIFORNIA-IRVINE, UNIVERSITY OF",26,1,50,10,0,15,102,103,98,107,0,205,41,61,0,2018
"219",219,"CALIFORNIA-LOS ANGELES, UNIVERSITY OF",37,0,46,11,0,18,112,171,135,148,0,283,38,74,0,2018
"220",220,"CAMPBELL UNIVERSITY",5,3,1,13,0,3,25,163,75,95,18,188,9,14,2,2018
"221",221,"CAPITAL UNIVERSITY",9,1,5,12,0,7,34,122,75,81,0,156,18,16,0,2018
"222",222,"CARDOZO SCHOOL OF LAW",30,0,22,12,0,9,73,207,124,156,0,280,22,51,0,2018
"223",223,"CASE WESTERN RESERVE UNIVERSITY",6,1,14,15,0,6,42,110,73,79,0,152,20,22,0,2018
"224",224,"CATHOLIC UNIVERSITY OF AMERICA",11,0,1,8,0,5,25,68,31,62,0,93,5,20,0,2018
"225",225,"CHAPMAN UNIVERSITY",38,0,17,1,0,13,69,65,56,78,0,134,30,39,0,2018
"226",226,"CHARLESTON SCHOOL OF LAW",12,2,1,21,2,0,38,144,72,110,0,182,12,26,0,2018
"227",227,"CHICAGO, UNIVERSITY OF",30,0,21,11,0,11,73,113,102,84,0,186,36,37,0,2018
"228",228,"CHICAGO-KENT COLLEGE OF LAW-IIT",30,0,16,13,0,7,66,158,111,113,0,224,26,40,0,2018
"229",229,"CINCINNATI, UNIVERSITY OF",6,2,5,11,0,7,31,94,62,63,0,125,16,15,0,2018
"230",230,"CITY UNIVERSITY OF NEW YORK",56,0,19,12,1,29,117,88,83,117,5,205,49,65,3,2018
"231",231,"CLEVELAND STATE UNIVERSITY",2,0,3,21,0,0,26,107,66,67,0,133,7,19,0,2018
"232",232,"COLORADO, UNIVERSITY OF",24,3,10,7,0,5,49,117,75,91,0,166,17,32,0,2018
"233",233,"COLUMBIA UNIVERSITY",29,0,65,40,0,11,145,217,187,175,0,362,55,90,0,2018
"234",234,"CONNECTICUT, UNIVERSITY OF",15,0,12,6,0,0,33,97,63,67,0,130,14,19,0,2018
"235",235,"CORNELL UNIVERSITY",34,3,28,12,0,3,80,92,95,77,0,172,37,43,0,2018
"236",236,"CREIGHTON UNIVERSITY",10,0,5,0,0,6,21,89,57,53,0,110,9,12,0,2018
"237",237,"DAYTON, UNIVERSITY OF",7,2,4,16,0,8,37,64,49,52,0,101,19,18,0,2018
"238",238,"DENVER, UNIVERSITY OF",36,0,6,5,0,8,55,178,102,131,0,233,20,35,0,2018
"239",239,"DEPAUL UNIVERSITY",42,0,14,17,0,7,80,141,105,116,0,221,36,44,0,2018
"240",240,"DETROIT MERCY, UNIVERSITY OF",3,0,2,7,0,2,14,59,30,43,0,73,4,10,0,2018
"241",241,"DISTRICT OF COLUMBIA",9,1,9,26,0,0,45,15,24,36,0,60,18,27,0,2018
"242",242,"DRAKE UNIVERSITY",2,0,3,3,0,6,14,95,58,51,0,109,7,7,0,2018
"243",243,"DREXEL UNIVERSITY",11,0,8,12,0,6,37,105,61,81,0,142,10,27,0,2018
"244",244,"DUKE UNIVERSITY",19,0,15,15,0,6,55,159,110,104,0,214,28,27,0,2018
"245",245,"DUQUESNE UNIVERSITY",7,1,7,10,0,0,25,143,74,94,0,168,14,11,0,2018
"246",246,"ELON UNIVERSITY",11,0,3,24,0,5,43,99,57,85,0,142,14,29,0,2018
"247",247,"EMORY UNIVERSITY",34,0,29,19,0,5,87,155,104,138,0,242,29,58,0,2018
"248",248,"FAULKNER UNIVERSITY",3,2,1,9,0,2,17,46,31,32,0,63,7,10,0,2018
"249",249,"FLORIDA A&M UNIVERSITY",40,0,3,88,0,5,136,51,80,106,1,187,49,86,1,2018
"250",250,"FLORIDA INTERNATIONAL UNIVERSITY",77,0,1,16,0,0,94,59,68,85,0,153,34,60,0,2018
"251",251,"FLORIDA STATE UNIVERSITY",32,0,5,17,0,10,64,148,94,118,0,212,25,39,0,2018
"252",252,"FLORIDA, UNIVERSITY OF",42,1,4,24,0,7,78,158,122,114,0,236,34,44,0,2018
"253",253,"FORDHAM UNIVERSITY",58,0,33,21,0,13,125,254,192,187,0,379,52,73,0,2018
"254",254,"GEORGE MASON UNIVERSITY",11,0,8,4,0,10,33,125,85,73,0,158,18,15,0,2018
"255",255,"GEORGE WASHINGTON UNIVERSITY",34,1,56,29,0,18,138,374,254,258,0,512,59,79,0,2018
"256",256,"GEORGETOWN UNIVERSITY",33,1,36,61,0,1,132,317,191,258,0,449,53,79,0,2018
"257",257,"GEORGIA STATE UNIVERSITY",18,0,17,41,0,9,85,165,116,134,0,250,27,58,0,2018
"258",258,"GEORGIA, UNIVERSITY OF",14,2,9,13,0,0,38,156,100,94,0,194,19,19,0,2018
"259",259,"GOLDEN GATE UNIVERSITY",63,0,22,33,1,20,139,88,97,130,0,227,51,88,0,2018
"260",260,"GONZAGA UNIVERSITY",10,1,2,1,0,5,19,115,67,67,0,134,9,10,0,2018
"261",261,"HARVARD UNIVERSITY",65,2,53,48,0,11,179,272,231,218,2,451,82,97,0,2018
"262",262,"HAWAII, UNIVERSITY OF",15,0,34,0,2,30,81,38,66,53,0,119,44,37,0,2018
"263",263,"HOFSTRA UNIVERSITY",30,1,18,18,0,2,69,183,132,120,0,252,32,37,0,2018
"264",264,"HOUSTON, UNIVERSITY OF",41,2,24,12,0,0,79,118,94,103,0,197,35,44,0,2018
"265",265,"HOWARD UNIVERSITY",1,0,1,131,1,17,151,2,64,89,0,153,63,88,0,2018
"266",266,"IDAHO, UNIVERSITY OF",14,3,3,4,1,6,31,83,58,56,0,114,11,20,0,2018
"267",267,"ILLINOIS, UNIVERSITY OF",18,0,17,5,0,2,42,74,65,51,0,116,23,19,0,2018
"268",268,"INDIANA UNIVERSITY - BLOOMINGTON",16,0,8,7,0,3,34,118,73,77,2,152,16,18,0,2018
"269",269,"INDIANA UNIVERSITY - INDIANAPOLIS",12,0,8,16,0,11,47,198,128,117,0,245,24,23,0,2018
"270",270,"INTER AMERICAN UNIVERSITY OF PUERTO RICO",183,0,0,4,0,0,187,2,71,114,4,189,71,112,4,2018
"271",271,"IOWA, UNIVERSITY OF",11,0,5,4,0,7,27,104,76,55,0,131,12,15,0,2018
"272",272,"KANSAS, UNIVERSITY OF",8,1,3,4,0,3,19,86,50,55,0,105,7,12,0,2018
"273",273,"KENTUCKY, UNIVERSITY OF",4,2,1,18,0,12,37,110,80,67,0,147,18,19,0,2018
"274",274,"LEWIS AND CLARK COLLEGE",15,3,6,1,0,9,34,124,62,96,0,158,10,24,0,2018
"275",275,"LIBERTY UNIVERSITY",6,0,4,3,0,5,18,55,43,30,0,73,9,9,0,2018
"276",276,"LINCOLN MEMORIAL",2,0,0,8,0,3,13,80,44,49,0,93,7,6,0,2018
"277",277,"LOUISIANA STATE UNIVERSITY",14,1,6,18,0,5,44,158,114,88,0,202,19,25,0,2018
"278",278,"LOUISVILLE, UNIVERSITY OF",7,0,3,2,0,4,16,114,59,71,0,130,3,13,0,2018
"279",279,"LOYOLA MARYMOUNT UNIVERSITY-LOS ANGELES",69,1,28,12,1,21,132,171,132,171,0,303,51,81,0,2018
"280",280,"LOYOLA UNIVERSITY-CHICAGO",36,1,17,22,0,10,86,188,111,163,0,274,19,67,0,2018
"281",281,"LOYOLA UNIVERSITY-NEW ORLEANS",18,3,5,22,0,2,50,104,69,85,0,154,20,30,0,2018
"282",282,"MAINE, UNIVERSITY OF",3,0,5,0,0,0,8,72,39,41,0,80,3,5,0,2018
"283",283,"MARQUETTE UNIVERSITY",24,0,1,12,0,6,43,147,91,99,0,190,23,20,0,2018
"284",284,"MARYLAND, UNIVERSITY OF",19,0,11,27,0,10,67,148,88,124,3,215,17,48,2,2018
"285",285,"MCGEORGE SCHOOL OF LAW",37,0,22,8,0,9,76,108,80,104,0,184,33,43,0,2018
"286",286,"MEMPHIS, UNIVERSITY OF",4,0,4,27,0,0,35,104,59,80,0,139,8,27,0,2018
"287",287,"MERCER UNIVERSITY",7,1,6,18,0,1,33,103,56,80,0,136,14,19,0,2018
"288",288,"MIAMI, UNIVERSITY OF",121,1,10,14,0,16,162,146,153,155,0,308,76,86,0,2018
"289",289,"MICHIGAN STATE UNIVERSITY",11,4,5,12,0,6,38,155,97,96,0,193,14,24,0,2018
"290",290,"MICHIGAN, UNIVERSITY OF",28,2,32,18,0,17,97,235,157,175,0,332,48,49,0,2018
"291",291,"MINNESOTA, UNIVERSITY OF",15,0,11,2,1,6,35,166,96,105,0,201,11,24,0,2018
"292",292,"MISSISSIPPI COLLEGE",1,5,2,22,0,0,30,72,50,52,0,102,14,16,0,2018
"293",293,"MISSISSIPPI, UNIVERSITY OF",7,1,2,25,0,3,38,107,84,61,0,145,17,21,0,2018
"294",294,"MISSOURI, UNIVERSITY OF",2,0,5,8,0,2,17,74,56,34,1,91,12,5,0,2018
"295",295,"MISSOURI-KANSAS CITY, UNIVERSITY OF",10,1,2,6,1,5,25,108,62,71,0,133,14,11,0,2018
"296",296,"MITCHELL | HAMLINE",24,3,21,35,2,11,96,269,169,195,1,365,37,59,0,2018
"297",297,"MONTANA, UNIVERSITY OF",5,3,1,2,0,0,11,65,36,40,0,76,3,8,0,2018
"298",298,"NEBRASKA, UNIVERSITY OF",6,0,2,2,0,0,10,121,65,66,0,131,6,4,0,2018
"299",299,"NEW ENGLAND LAW | BOSTON",19,1,9,14,0,5,48,134,62,120,0,182,15,33,0,2018
"300",300,"NEW HAMPSHIRE, UNIVERSITY OF",7,0,3,3,0,4,17,69,43,43,0,86,7,10,0,2018
"301",301,"NEW MEXICO, UNIVERSITY OF",17,8,1,2,0,26,54,43,40,57,0,97,18,36,0,2018
"302",302,"NEW YORK LAW SCHOOL",53,0,21,19,0,14,107,223,144,186,0,330,40,67,0,2018
"303",303,"NEW YORK UNIVERSITY",45,0,40,28,0,22,135,243,177,199,2,378,51,84,0,2018
"304",304,"NORTH CAROLINA CENTRAL UNIVERSITY",5,1,1,55,0,0,62,40,29,73,0,102,13,49,0,2018
"305",305,"NORTH CAROLINA, UNIVERSITY OF",20,0,10,12,0,10,52,142,89,105,0,194,16,36,0,2018
"306",306,"NORTH DAKOTA, UNIVERSITY OF",3,1,0,0,0,0,4,48,28,24,0,52,2,2,0,2018
"307",307,"NORTHEASTERN UNIVERSITY SCHOOL OF LAW",26,0,24,12,1,10,73,117,66,123,1,190,18,55,0,2018
"308",308,"NORTHERN ILLINOIS UNIVERSITY",9,0,2,8,0,8,27,63,47,43,0,90,15,12,0,2018
"309",309,"NORTHERN KENTUCKY UNIVERSITY",3,0,3,8,0,0,14,128,72,70,0,142,8,6,0,2018
"310",310,"NORTHWESTERN UNIVERSITY",23,1,22,11,0,12,69,151,97,123,0,220,24,45,0,2018
"311",311,"NOTRE DAME, UNIVERSITY OF",17,1,16,7,0,9,50,126,83,93,0,176,19,31,0,2018
"312",312,"NOVA SOUTHEASTERN UNIVERSITY",66,0,5,18,1,3,93,91,89,95,0,184,36,57,0,2018
"313",313,"OHIO NORTHERN UNIVERSITY",0,0,3,5,0,0,8,42,24,26,0,50,0,8,0,2018
"314",314,"OHIO STATE UNIVERSITY",13,1,6,10,0,12,42,135,84,93,0,177,22,20,0,2018
"315",315,"OKLAHOMA CITY UNIVERSITY",12,10,8,6,0,20,56,99,81,74,0,155,27,29,0,2018
"316",316,"OKLAHOMA, UNIVERSITY OF",14,10,3,7,0,20,54,116,81,89,0,170,23,31,0,2018
"317",317,"OREGON, UNIVERSITY OF",2,0,8,4,0,15,29,90,52,67,0,119,9,20,0,2018
"318",318,"PACE UNIVERSITY",14,1,6,13,0,14,48,129,69,108,0,177,12,36,0,2018
"319",319,"PENNSYLVANIA STATE - DICKINSON LAW",4,0,5,6,0,2,17,53,43,27,0,70,7,10,0,2018
"320",320,"PENNSYLVANIA STATE - PENN STATE LAW",5,0,2,7,0,8,22,93,45,70,0,115,9,13,0,2018
"321",321,"PENNSYLVANIA, UNIVERSITY OF",13,1,33,20,0,16,83,143,108,118,0,226,35,48,0,2018
"322",322,"PEPPERDINE UNIVERSITY",15,0,5,13,0,8,41,104,68,77,0,145,16,25,0,2018
"323",323,"PITTSBURGH, UNIVERSITY OF",8,0,7,3,0,2,20,95,68,46,1,115,12,8,0,2018
"324",324,"PONTIFICAL CATHOLIC UNIVERSITY OF P.R.",144,0,0,0,0,0,144,0,50,94,0,144,50,94,0,2018
"325",325,"PUERTO RICO, UNIVERSITY OF",132,0,1,0,0,25,158,0,56,102,0,158,56,102,0,2018
"326",326,"QUINNIPIAC UNIVERSITY",8,0,4,7,0,2,21,89,42,68,0,110,7,14,0,2018
"327",327,"REGENT UNIVERSITY",5,1,4,5,0,4,19,86,42,63,0,105,5,14,0,2018
"328",328,"RICHMOND, UNIVERSITY OF",2,0,0,8,0,8,18,110,63,65,0,128,10,8,0,2018
"329",329,"ROGER WILLIAMS UNIVERSITY",24,0,7,12,0,5,48,113,70,91,0,161,13,35,0,2018
"330",330,"RUTGERS UNIVERSITY",57,3,46,30,1,0,137,226,188,175,0,363,64,73,0,2018
"331",331,"SAINT LOUIS UNIVERSITY",3,0,11,16,0,3,33,140,79,94,0,173,10,23,0,2018
"332",332,"SAMFORD UNIVERSITY",5,0,2,14,0,0,21,117,73,65,0,138,12,9,0,2018
"333",333,"SAN DIEGO, UNIVERSITY OF",38,2,23,9,2,6,80,148,99,129,0,228,34,46,0,2018
"334",334,"SAN FRANCISCO, UNIVERSITY OF",36,0,17,7,0,12,72,64,57,79,0,136,28,44,0,2018
"335",335,"SANTA CLARA UNIVERSITY",61,0,53,7,1,19,141,134,118,156,1,275,56,84,1,2018
"336",336,"SEATTLE UNIVERSITY",24,2,16,10,2,9,63,142,80,125,0,205,23,40,0,2018
"337",337,"SETON HALL UNIVERSITY",22,0,18,15,0,7,62,172,119,115,0,234,27,35,0,2018
"338",338,"SOUTH CAROLINA, UNIVERSITY OF",9,2,4,23,0,4,42,169,110,100,1,211,20,22,0,2018
"339",339,"SOUTH DAKOTA, UNIVERSITY OF",2,2,0,2,0,3,9,61,39,31,0,70,3,6,0,2018
"340",340,"SOUTH TEXAS COLLEGE OF LAW HOUSTON",141,1,38,54,1,6,241,237,215,263,0,478,91,150,0,2018
"341",341,"SOUTHERN CALIFORNIA, UNIVERSITY OF",20,0,25,17,0,12,74,107,83,98,0,181,25,49,0,2018
"342",342,"SOUTHERN ILLINOIS UNIVERSITY-CARBONDALE",2,0,1,11,0,4,18,57,39,36,0,75,12,6,0,2018
"343",343,"SOUTHERN METHODIST UNIVERSITY",20,1,14,10,0,14,59,136,89,106,0,195,26,33,0,2018
"344",344,"SOUTHERN UNIVERSITY",7,1,3,136,0,14,161,78,106,133,0,239,57,104,0,2018
"345",345,"SOUTHWESTERN LAW SCHOOL",75,0,21,12,2,18,128,143,126,144,1,271,52,75,1,2018
"346",346,"ST. JOHN'S UNIVERSITY",17,0,20,22,0,5,64,168,110,122,0,232,25,39,0,2018
"347",347,"ST. MARY'S UNIVERSITY",137,3,9,14,0,0,163,108,133,138,0,271,78,85,0,2018
"348",348,"ST. THOMAS UNIVERSITY (FLORIDA)",118,3,3,18,0,4,146,33,61,118,0,179,46,100,0,2018
"349",349,"ST. THOMAS, UNIVERSITY OF (MINNESOTA)",10,0,4,6,0,5,25,119,65,79,0,144,7,18,0,2018
"350",350,"STANFORD UNIVERSITY",27,0,15,11,0,14,67,100,84,83,0,167,30,37,0,2018
"351",351,"STETSON UNIVERSITY",35,0,6,23,0,8,72,211,125,158,0,283,29,43,0,2018
"352",352,"SUFFOLK UNIVERSITY",36,0,14,16,0,5,71,277,169,179,0,348,27,44,0,2018
"353",353,"SYRACUSE UNIVERSITY",28,0,14,18,0,2,62,116,76,102,0,178,21,41,0,2018
"354",354,"TEMPLE UNIVERSITY",25,0,20,14,0,11,70,147,99,118,0,217,25,45,0,2018
"355",355,"TENNESSEE, UNIVERSITY OF",10,1,0,10,0,5,26,93,60,59,0,119,11,15,0,2018
"356",356,"TEXAS A&M UNIVERSITY",40,0,8,5,0,9,62,115,69,108,0,177,26,36,0,2018
"357",357,"TEXAS AT AUSTIN, UNIVERSITY OF",66,2,24,13,0,20,125,242,198,169,0,367,61,64,0,2018
"358",358,"TEXAS SOUTHERN UNIVERSITY THURGOOD MARSHALL SCHOOL OF LAW",50,3,19,96,0,0,168,30,73,125,0,198,64,104,0,2018
"359",359,"TEXAS TECH UNIVERSITY",10,1,4,7,0,26,48,93,79,62,0,141,23,25,0,2018
"360",360,"TOLEDO, UNIVERSITY OF",7,0,7,2,0,4,20,80,39,61,0,100,5,15,0,2018
"361",361,"TOURO UNIVERSITY",22,1,17,23,0,17,80,131,116,95,0,211,40,40,0,2018
"362",362,"TULANE UNIVERSITY",29,0,3,18,0,2,52,151,87,116,0,203,19,33,0,2018
"363",363,"TULSA, UNIVERSITY OF",5,5,3,3,0,17,33,64,52,45,0,97,16,17,0,2018
"364",364,"UNIVERSITY OF BUFFALO-SUNY",13,1,8,7,0,5,34,97,61,69,1,131,13,21,0,2018
"365",365,"UNIVERSITY OF CALIFORNIA COLLEGE OF THE LAW, SAN FRANCISCO",59,2,74,6,1,0,142,145,115,172,0,287,60,82,0,2018
"366",366,"UNIVERSITY OF ILLINOIS CHICAGO SCHOOL OF LAW",50,1,26,41,1,7,126,246,150,215,7,372,41,81,4,2018
"367",367,"UNIVERSITY OF MASSACHUSETTS DARTMOUTH",12,2,5,9,0,5,33,65,45,53,0,98,13,20,0,2018
"368",368,"UNIVERSITY OF NEVADA - LAS VEGAS",26,0,11,10,0,5,52,100,76,76,0,152,26,26,0,2018
"369",369,"UTAH, UNIVERSITY OF",13,4,4,0,0,0,21,71,55,37,0,92,9,12,0,2018
"370",370,"VANDERBILT UNIVERSITY",9,1,19,21,0,0,50,121,81,90,0,171,19,31,0,2018
"371",371,"VERMONT LAW SCHOOL",15,0,9,14,1,4,43,125,74,94,0,168,21,22,0,2018
"372",372,"VILLANOVA UNIVERSITY",20,0,4,7,0,9,40,135,76,99,0,175,20,20,0,2018
"373",373,"VIRGINIA, UNIVERSITY OF",20,1,24,18,0,9,72,234,171,135,0,306,39,33,0,2018
"374",374,"WAKE FOREST UNIVERSITY",15,1,1,10,0,4,31,146,89,88,0,177,12,19,0,2018
"375",375,"WASHBURN UNIVERSITY",7,0,0,5,0,5,17,91,56,52,0,108,9,8,0,2018
"376",376,"WASHINGTON AND LEE UNIVERSITY",7,0,12,6,0,0,25,92,63,54,0,117,9,16,0,2018
"377",377,"WASHINGTON UNIVERSITY",10,0,18,25,0,6,59,144,119,84,0,203,31,28,0,2018
"378",378,"WASHINGTON, UNIVERSITY OF",12,2,20,5,1,12,52,106,61,97,0,158,19,33,0,2018
"379",379,"WAYNE STATE UNIVERSITY",3,1,1,9,0,0,14,101,53,62,0,115,3,11,0,2018
"380",380,"WEST VIRGINIA UNIVERSITY",3,0,2,2,0,5,12,98,62,48,0,110,8,4,0,2018
"381",381,"COOLEY LAW SCHOOL",34,2,22,195,4,92,349,341,277,412,1,690,123,225,1,2018
"382",382,"WESTERN NEW ENGLAND UNIVERSITY",10,1,2,7,0,0,20,60,43,37,0,80,11,9,0,2018
"383",383,"WESTERN STATE COLLEGE OF LAW",70,6,16,6,1,5,104,54,75,83,0,158,47,57,0,2018
"384",384,"WIDENER UNIVERSITY-DELAWARE",9,2,15,20,0,4,50,151,99,102,0,201,19,31,0,2018
"385",385,"WIDENER-COMMONWEALTH",12,1,5,14,0,0,32,87,50,69,0,119,10,22,0,2018
"386",386,"WILLAMETTE UNIVERSITY",18,2,2,3,0,7,32,91,60,61,2,123,16,16,0,2018
"387",387,"WILLIAM AND MARY LAW SCHOOL",4,0,5,13,0,5,27,150,73,104,0,177,8,19,0,2018
"388",388,"WISCONSIN, UNIVERSITY OF",23,1,12,8,1,10,55,202,131,126,0,257,28,27,0,2018
"389",389,"WYOMING, UNIVERSITY OF",3,2,2,0,0,0,7,77,49,35,0,84,5,2,0,2018
"390",390,"YALE UNIVERSITY",24,0,28,14,0,17,83,109,96,95,1,192,39,44,0,2018
"391",391,"AKRON, UNIVERSITY OF",3,0,2,3,0,6,14,89,59,44,0,103,8,6,0,2019
"392",392,"ALABAMA, UNIVERSITY OF",6,0,4,14,0,2,26,104,60,70,0,130,6,20,0,2019
"393",393,"ALBANY LAW SCHOOL",13,0,10,11,0,7,41,133,78,96,0,174,14,27,0,2019
"394",394,"AMERICAN UNIVERSITY",44,0,24,28,0,33,129,230,122,237,0,359,40,89,0,2019
"395",395,"APPALACHIAN SCHOOL OF LAW",10,3,3,7,0,0,23,43,35,31,0,66,10,13,0,2019
"396",396,"ARIZONA STATE UNIVERSITY",33,6,12,7,0,18,76,181,119,137,1,257,29,47,0,2019
"397",397,"ARIZONA, UNIVERSITY OF",14,5,5,5,0,6,35,101,78,58,0,136,21,14,0,2019
"398",398,"ARKANSAS, FAYETTEVILLE, UNIVERSITY OF",7,1,1,4,0,2,15,95,60,50,0,110,10,5,0,2019
"399",399,"ARKANSAS, LITTLE ROCK, UNIVERSITY OF",6,4,5,7,0,0,22,129,78,73,0,151,10,12,0,2019
"400",400,"ATLANTA'S JOHN MARSHALL LAW SCHOOL",2,0,0,18,0,0,20,27,19,28,0,47,6,14,0,2019
"401",401,"AVE MARIA SCHOOL OF LAW",22,1,1,7,1,0,32,69,46,55,0,101,11,21,0,2019
"402",402,"BALTIMORE, UNIVERSITY OF",28,0,17,41,0,15,101,155,116,140,0,256,40,61,0,2019
"403",403,"BARRY UNIVERSITY",69,5,10,32,0,2,118,113,102,129,0,231,54,64,0,2019
"404",404,"BAYLOR UNIVERSITY",21,5,14,2,0,3,45,123,82,86,0,168,21,24,0,2019
"405",405,"BELMONT UNIVERSITY",5,1,2,4,0,4,16,120,46,90,0,136,2,14,0,2019
"406",406,"BOSTON COLLEGE",13,0,30,14,1,6,64,176,103,135,2,240,22,40,2,2019
"407",407,"BOSTON UNIVERSITY",34,0,22,7,0,10,73,142,98,117,0,215,27,46,0,2019
"408",408,"BRIGHAM YOUNG UNIVERSITY",2,1,3,3,1,6,16,102,68,50,0,118,11,5,0,2019
"409",409,"BROOKLYN LAW SCHOOL",52,0,45,13,0,19,129,243,150,221,1,372,52,76,1,2019
"410",410,"CALIFORNIA WESTERN SCHOOL OF LAW",44,1,18,6,1,45,115,117,94,138,0,232,47,68,0,2019
"411",411,"CALIFORNIA-BERKELEY, UNIVERSITY OF",38,0,46,16,0,24,124,186,121,187,2,310,44,78,2,2019
"412",412,"CALIFORNIA-DAVIS, UNIVERSITY OF",33,1,52,6,0,21,113,105,92,126,0,218,44,69,0,2019
"413",413,"CALIFORNIA-IRVINE, UNIVERSITY OF",32,0,22,10,0,12,76,63,60,77,2,139,28,46,2,2019
"414",414,"CALIFORNIA-LOS ANGELES, UNIVERSITY OF",31,0,34,17,0,22,104,170,110,162,2,274,28,74,2,2019
"415",415,"CAMPBELL UNIVERSITY",16,2,5,11,0,0,34,144,58,120,0,178,12,22,0,2019
"416",416,"CAPITAL UNIVERSITY",5,0,2,11,0,15,33,136,85,84,0,169,16,17,0,2019
"417",417,"CARDOZO SCHOOL OF LAW",25,0,21,14,0,7,67,206,125,147,1,273,25,42,0,2019
"418",418,"CASE WESTERN RESERVE UNIVERSITY",5,0,6,7,0,2,20,94,41,73,0,114,4,16,0,2019
"419",419,"CATHOLIC UNIVERSITY OF AMERICA",12,0,0,7,0,4,23,78,41,60,0,101,9,14,0,2019
"420",420,"CHAPMAN UNIVERSITY",38,0,13,4,0,7,62,81,63,80,0,143,26,36,0,2019
"421",421,"CHARLESTON SCHOOL OF LAW",15,7,3,13,0,0,38,174,94,118,0,212,17,21,0,2019
"422",422,"CHICAGO, UNIVERSITY OF",36,0,23,11,0,8,78,113,92,98,1,191,34,43,1,2019
"423",423,"CHICAGO-KENT COLLEGE OF LAW-IIT",33,1,11,13,0,8,66,159,102,123,0,225,21,45,0,2019
"424",424,"CINCINNATI, UNIVERSITY OF",10,2,3,8,0,1,24,105,52,77,0,129,9,15,0,2019
"425",425,"CITY UNIVERSITY OF NEW YORK",54,1,22,21,1,27,126,90,72,139,5,216,40,83,3,2019
"426",426,"CLEVELAND STATE UNIVERSITY",8,3,0,17,0,0,28,113,69,72,0,141,12,16,0,2019
"427",427,"COLORADO, UNIVERSITY OF",28,3,5,4,0,16,56,114,76,94,0,170,20,36,0,2019
"428",428,"COLUMBIA UNIVERSITY",29,0,47,39,0,10,125,174,162,136,1,299,56,69,0,2019
"429",429,"CONNECTICUT, UNIVERSITY OF",15,0,8,7,0,0,30,119,69,80,0,149,12,18,0,2019
"430",430,"CORNELL UNIVERSITY",30,2,50,11,0,7,100,91,93,98,0,191,44,56,0,2019
"431",431,"CREIGHTON UNIVERSITY",13,0,4,11,0,3,31,83,69,45,0,114,19,12,0,2019
"432",432,"DAYTON, UNIVERSITY OF",8,0,4,12,1,5,30,85,49,66,0,115,10,20,0,2019
"433",433,"DENVER, UNIVERSITY OF",28,0,4,9,0,9,50,211,122,137,2,261,31,18,1,2019
"434",434,"DEPAUL UNIVERSITY",29,0,13,18,0,9,69,130,86,113,0,199,22,47,0,2019
"435",435,"DETROIT MERCY, UNIVERSITY OF",5,1,7,14,0,5,32,85,53,64,0,117,15,17,0,2019
"436",436,"DISTRICT OF COLUMBIA",8,0,9,40,0,0,57,20,20,57,0,77,12,45,0,2019
"437",437,"DRAKE UNIVERSITY",4,0,0,5,0,0,9,105,61,53,0,114,4,5,0,2019
"438",438,"DREXEL UNIVERSITY",9,0,7,11,0,4,31,124,55,96,4,155,11,20,0,2019
"439",439,"DUKE UNIVERSITY",16,0,22,17,2,9,66,132,80,117,1,198,19,46,1,2019
"440",440,"DUQUESNE UNIVERSITY",7,1,8,11,0,1,28,121,86,63,0,149,13,15,0,2019
"441",441,"ELON UNIVERSITY",4,0,2,25,0,14,45,95,55,85,0,140,14,31,0,2019
"442",442,"EMORY UNIVERSITY",28,0,26,13,1,9,77,122,93,106,0,199,33,44,0,2019
"443",443,"FAULKNER UNIVERSITY",4,0,3,4,0,2,13,49,35,27,0,62,7,6,0,2019
"444",444,"FLORIDA A&M UNIVERSITY",15,0,2,105,0,32,154,58,75,137,0,212,46,108,0,2019
"445",445,"FLORIDA INTERNATIONAL UNIVERSITY",80,0,4,11,0,3,98,48,65,81,0,146,41,57,0,2019
"446",446,"FLORIDA STATE UNIVERSITY",36,0,5,13,0,9,63,130,89,104,0,193,24,39,0,2019
"447",447,"FLORIDA, UNIVERSITY OF",25,1,4,17,0,2,49,112,85,76,0,161,23,26,0,2019
"448",448,"FORDHAM UNIVERSITY",43,0,39,20,0,25,127,256,178,205,0,383,46,81,0,2019
"449",449,"GEORGE MASON UNIVERSITY",13,0,9,0,0,4,26,105,71,60,0,131,9,17,0,2019
"450",450,"GEORGE WASHINGTON UNIVERSITY",13,3,69,32,0,2,119,305,185,237,2,424,44,74,1,2019
"451",451,"GEORGETOWN UNIVERSITY",33,0,59,51,0,13,156,359,241,272,2,515,66,90,0,2019
"452",452,"GEORGIA STATE UNIVERSITY",19,0,13,32,0,8,72,204,122,154,0,276,24,48,0,2019
"453",453,"GEORGIA, UNIVERSITY OF",7,0,8,16,1,0,32,154,100,86,0,186,16,16,0,2019
"454",454,"GOLDEN GATE UNIVERSITY",36,1,19,11,2,5,74,40,51,63,0,114,28,46,0,2019
"455",455,"GONZAGA UNIVERSITY",12,2,2,3,0,3,22,109,65,66,0,131,13,9,0,2019
"456",456,"HARVARD UNIVERSITY",55,3,59,48,0,24,189,283,237,234,1,472,87,102,0,2019
"457",457,"HAWAII, UNIVERSITY OF",7,0,33,1,6,25,72,25,35,62,0,97,27,45,0,2019
"458",458,"HOFSTRA UNIVERSITY",29,0,19,16,3,9,76,179,115,140,0,255,29,47,0,2019
"459",459,"HOUSTON, UNIVERSITY OF",33,0,24,9,0,9,75,131,97,109,0,206,34,41,0,2019
"460",460,"HOWARD UNIVERSITY",6,0,2,122,0,26,156,0,50,106,0,156,50,106,0,2019
"461",461,"IDAHO, UNIVERSITY OF",17,3,1,1,0,8,30,96,68,58,0,126,16,14,0,2019
"462",462,"ILLINOIS, UNIVERSITY OF",5,0,4,7,0,5,21,81,59,43,0,102,12,9,0,2019
"463",463,"INDIANA UNIVERSITY - BLOOMINGTON",10,0,7,8,0,3,28,128,63,93,0,156,12,16,0,2019
"464",464,"INDIANA UNIVERSITY - INDIANAPOLIS",10,3,16,18,1,0,48,212,138,122,0,260,23,25,0,2019
"465",465,"INTER AMERICAN UNIVERSITY OF PUERTO RICO",142,0,0,4,0,0,146,2,45,103,0,148,44,102,0,2019
"466",466,"IOWA, UNIVERSITY OF",13,0,5,5,0,4,27,108,73,62,0,135,15,12,0,2019
"467",467,"KANSAS, UNIVERSITY OF",9,0,3,3,0,2,17,88,48,57,0,105,8,9,0,2019
"468",468,"KENTUCKY, UNIVERSITY OF",4,1,3,7,0,0,15,81,46,50,0,96,6,9,0,2019
"469",469,"LEWIS AND CLARK COLLEGE",19,5,12,8,0,2,46,126,73,99,0,172,16,30,0,2019
"470",470,"LIBERTY UNIVERSITY",12,1,1,4,0,6,24,56,44,36,0,80,10,14,0,2019
"471",471,"LINCOLN MEMORIAL",3,1,3,5,0,7,19,81,46,54,0,100,11,8,0,2019
"472",472,"LOUISIANA STATE UNIVERSITY",12,1,1,25,0,5,44,162,98,108,0,206,17,27,0,2019
"473",473,"LOUISVILLE, UNIVERSITY OF",4,0,2,5,0,4,15,79,42,51,1,94,6,9,0,2019
"474",474,"LOYOLA MARYMOUNT UNIVERSITY-LOS ANGELES",69,0,34,11,1,25,140,173,142,170,1,313,63,76,1,2019
"475",475,"LOYOLA UNIVERSITY-CHICAGO",25,0,16,9,0,17,67,193,117,142,1,260,30,36,1,2019
"476",476,"LOYOLA UNIVERSITY-NEW ORLEANS",31,0,4,18,1,9,63,108,66,105,0,171,20,43,0,2019
"477",477,"MAINE, UNIVERSITY OF",5,1,0,1,0,1,8,82,48,42,0,90,5,3,0,2019
"478",478,"MARQUETTE UNIVERSITY",29,0,6,7,0,4,46,154,108,92,0,200,22,24,0,2019
"479",479,"MARYLAND, UNIVERSITY OF",12,1,12,20,0,8,53,157,66,139,5,210,9,43,1,2019
"480",480,"MCGEORGE SCHOOL OF LAW",21,5,27,3,0,11,67,100,79,86,2,167,28,39,0,2019
"481",481,"MEMPHIS, UNIVERSITY OF",6,1,8,26,0,0,41,91,66,66,0,132,13,28,0,2019
"482",482,"MERCER UNIVERSITY",5,1,6,15,0,2,29,101,72,58,0,130,13,16,0,2019
"483",483,"MIAMI, UNIVERSITY OF",122,2,7,16,0,13,160,160,181,139,0,320,77,83,0,2019
"484",484,"MICHIGAN STATE UNIVERSITY",7,5,8,12,0,10,42,185,103,124,0,227,17,25,0,2019
"485",485,"MICHIGAN, UNIVERSITY OF",16,1,30,13,1,23,84,218,137,162,3,302,38,44,2,2019
"486",486,"MINNESOTA, UNIVERSITY OF",21,0,7,2,0,11,41,182,105,118,0,223,24,17,0,2019
"487",487,"MISSISSIPPI COLLEGE",1,0,3,15,0,1,20,83,50,53,0,103,7,13,0,2019
"488",488,"MISSISSIPPI, UNIVERSITY OF",23,0,1,26,0,5,55,102,73,84,0,157,20,35,0,2019
"489",489,"MISSOURI, UNIVERSITY OF",5,0,0,7,0,3,15,79,48,46,0,94,8,7,0,2019
"490",490,"MISSOURI-KANSAS CITY, UNIVERSITY OF",11,1,5,5,0,3,25,103,63,65,0,128,12,13,0,2019
"491",491,"MITCHELL | HAMLINE",29,5,9,17,1,8,69,269,137,199,2,338,29,40,0,2019
"492",492,"MONTANA, UNIVERSITY OF",2,4,2,3,0,0,11,73,42,42,0,84,6,5,0,2019
"493",493,"NEBRASKA, UNIVERSITY OF",5,1,5,0,0,0,11,126,58,79,0,137,2,9,0,2019
"494",494,"NEW ENGLAND LAW | BOSTON",44,1,12,24,1,11,93,241,121,213,0,334,29,64,0,2019
"495",495,"NEW HAMPSHIRE, UNIVERSITY OF",5,0,8,4,0,5,22,109,75,56,0,131,15,7,0,2019
"496",496,"NEW MEXICO, UNIVERSITY OF",31,6,2,2,0,0,41,36,33,44,0,77,18,23,0,2019
"497",497,"NEW YORK LAW SCHOOL",54,0,28,10,1,14,107,251,149,209,0,358,44,63,0,2019
"498",498,"NEW YORK UNIVERSITY",43,0,43,32,0,20,138,260,198,197,3,398,56,82,0,2019
"499",499,"NORTH CAROLINA CENTRAL UNIVERSITY",10,6,4,80,0,0,100,46,49,97,0,146,24,76,0,2019
"500",500,"NORTH CAROLINA, UNIVERSITY OF",12,3,10,7,0,9,41,135,91,85,0,176,20,21,0,2019
"501",501,"NORTH DAKOTA, UNIVERSITY OF",2,0,3,1,0,5,11,56,39,28,0,67,4,7,0,2019
"502",502,"NORTHEASTERN UNIVERSITY SCHOOL OF LAW",28,0,14,9,0,13,64,133,57,139,1,197,15,49,0,2019
"503",503,"NORTHERN ILLINOIS UNIVERSITY",14,0,5,11,0,0,30,92,62,60,0,122,12,18,0,2019
"504",504,"NORTHERN KENTUCKY UNIVERSITY",8,1,3,9,0,1,22,107,63,66,0,129,7,15,0,2019
"505",505,"NORTHWESTERN UNIVERSITY",21,2,28,16,0,6,73,141,106,105,3,214,33,40,0,2019
"506",506,"NOTRE DAME, UNIVERSITY OF",24,0,15,13,1,6,59,144,99,104,0,203,25,34,0,2019
"507",507,"NOVA SOUTHEASTERN UNIVERSITY",86,0,3,13,1,5,108,87,93,102,0,195,50,58,0,2019
"508",508,"OHIO NORTHERN UNIVERSITY",3,0,2,6,0,1,12,35,24,23,0,47,7,5,0,2019
"509",509,"OHIO STATE UNIVERSITY",10,0,10,8,0,3,31,153,90,93,1,184,11,20,0,2019
"510",510,"OKLAHOMA CITY UNIVERSITY",25,5,6,7,0,11,54,116,71,99,0,170,17,37,0,2019
"511",511,"OKLAHOMA, UNIVERSITY OF",15,6,7,4,0,15,47,117,79,85,0,164,19,28,0,2019
"512",512,"OREGON, UNIVERSITY OF",13,3,2,4,0,14,36,111,71,76,0,147,14,22,0,2019
"513",513,"PACE UNIVERSITY",24,0,10,14,0,25,73,150,90,133,0,223,25,48,0,2019
"514",514,"PENNSYLVANIA STATE - DICKINSON LAW",4,0,3,3,0,2,12,59,40,31,0,71,8,4,0,2019
"515",515,"PENNSYLVANIA STATE - PENN STATE LAW",8,0,7,8,0,2,25,101,56,70,0,126,7,18,0,2019
"516",516,"PENNSYLVANIA, UNIVERSITY OF",21,0,27,18,0,23,89,142,119,112,0,231,40,49,0,2019
"517",517,"PEPPERDINE UNIVERSITY",18,0,12,13,0,9,52,127,91,88,0,179,25,27,0,2019
"518",518,"PITTSBURGH, UNIVERSITY OF",8,0,7,4,0,2,21,88,57,52,0,109,8,13,0,2019
"519",519,"PONTIFICAL CATHOLIC UNIVERSITY OF P.R.",133,0,0,0,0,0,133,0,53,80,0,133,53,80,0,2019
"520",520,"PUERTO RICO, UNIVERSITY OF",102,0,0,0,0,26,128,1,58,71,0,129,58,70,0,2019
"521",521,"QUINNIPIAC UNIVERSITY",13,0,4,5,0,4,26,113,53,86,0,139,10,16,0,2019
"522",522,"REGENT UNIVERSITY",7,1,2,6,0,1,17,98,52,63,0,115,7,10,0,2019
"523",523,"RICHMOND, UNIVERSITY OF",9,0,6,12,0,3,30,90,52,68,0,120,14,16,0,2019
"524",524,"ROGER WILLIAMS UNIVERSITY",25,1,7,12,1,2,48,125,63,110,0,173,15,33,0,2019
"525",525,"RUTGERS UNIVERSITY",47,0,32,36,2,8,125,263,195,193,0,388,57,68,0,2019
"526",526,"SAINT LOUIS UNIVERSITY",7,0,7,21,0,6,41,157,89,106,3,198,12,28,1,2019
"527",527,"SAMFORD UNIVERSITY",5,0,1,14,0,1,21,136,70,87,0,157,9,12,0,2019
"528",528,"SAN DIEGO, UNIVERSITY OF",36,1,18,5,0,13,73,159,103,129,0,232,30,43,0,2019
"529",529,"SAN FRANCISCO, UNIVERSITY OF",48,0,14,12,1,9,84,46,55,75,0,130,35,49,0,2019
"530",530,"SANTA CLARA UNIVERSITY",61,0,69,4,2,12,148,108,128,128,0,256,71,77,0,2019
"531",531,"SEATTLE UNIVERSITY",34,2,21,10,0,19,86,130,84,132,0,216,27,59,0,2019
"532",532,"SETON HALL UNIVERSITY",25,0,14,7,0,3,49,155,107,97,0,204,19,30,0,2019
"533",533,"SOUTH CAROLINA, UNIVERSITY OF",17,1,2,19,0,5,44,167,113,98,0,211,15,29,0,2019
"534",534,"SOUTH DAKOTA, UNIVERSITY OF",1,4,0,0,0,2,7,79,54,31,1,86,4,3,0,2019
"535",535,"SOUTH TEXAS COLLEGE OF LAW HOUSTON",144,3,47,41,1,0,236,251,222,265,0,487,95,141,0,2019
"536",536,"SOUTHERN CALIFORNIA, UNIVERSITY OF",19,1,31,18,0,13,82,104,84,102,0,186,32,50,0,2019
"537",537,"SOUTHERN ILLINOIS UNIVERSITY-CARBONDALE",4,0,4,3,0,8,19,67,38,48,0,86,7,12,0,2019
"538",538,"SOUTHERN METHODIST UNIVERSITY",29,1,18,15,0,11,74,187,115,146,0,261,24,50,0,2019
"539",539,"SOUTHERN UNIVERSITY",17,1,4,132,1,9,164,72,80,156,0,236,45,119,0,2019
"540",540,"SOUTHWESTERN LAW SCHOOL",88,0,41,24,0,17,170,158,138,190,0,328,64,106,0,2019
"541",541,"ST. JOHN'S UNIVERSITY",35,0,16,16,0,10,77,166,99,144,0,243,31,46,0,2019
"542",542,"ST. MARY'S UNIVERSITY",146,2,8,13,0,0,169,117,121,165,0,286,70,99,0,2019
"543",543,"ST. THOMAS UNIVERSITY (FLORIDA)",158,0,2,22,0,3,185,44,93,136,0,229,70,115,0,2019
"544",544,"ST. THOMAS, UNIVERSITY OF (MINNESOTA)",9,0,6,6,0,3,24,126,61,89,0,150,11,13,0,2019
"545",545,"STANFORD UNIVERSITY",30,0,14,16,0,16,76,95,74,95,2,171,28,46,2,2019
"546",546,"STETSON UNIVERSITY",52,3,14,15,0,1,85,203,136,152,0,288,38,47,0,2019
"547",547,"SUFFOLK UNIVERSITY",30,0,21,18,0,8,77,264,155,185,1,341,32,45,0,2019
"548",548,"SYRACUSE UNIVERSITY",26,0,19,19,1,11,76,181,128,129,0,257,31,45,0,2019
"549",549,"TEMPLE UNIVERSITY",22,2,21,19,0,12,76,154,116,112,2,230,33,43,0,2019
"550",550,"TENNESSEE, UNIVERSITY OF",11,0,1,8,0,4,24,101,61,63,1,125,10,14,0,2019
"551",551,"TEXAS A&M UNIVERSITY",34,0,6,10,0,2,52,116,73,94,1,168,22,30,0,2019
"552",552,"TEXAS AT AUSTIN, UNIVERSITY OF",40,1,32,10,0,10,93,172,139,126,0,265,35,58,0,2019
"553",553,"TEXAS SOUTHERN UNIVERSITY THURGOOD MARSHALL SCHOOL OF LAW",47,0,11,120,0,2,180,15,69,126,0,195,61,119,0,2019
"554",554,"TEXAS TECH UNIVERSITY",18,0,4,10,0,22,54,90,72,72,0,144,22,32,0,2019
"555",555,"TOLEDO, UNIVERSITY OF",3,0,1,6,0,6,16,84,46,54,0,100,5,11,0,2019
"556",556,"TOURO UNIVERSITY",17,0,19,14,0,29,79,106,79,106,0,185,26,53,0,2019
"557",557,"TULANE UNIVERSITY",28,2,10,20,0,1,61,143,88,116,0,204,31,30,0,2019
"558",558,"TULSA, UNIVERSITY OF",7,3,1,6,1,18,36,89,56,69,0,125,18,18,0,2019
"559",559,"UNIVERSITY OF BUFFALO-SUNY",10,0,4,7,0,4,25,107,67,65,0,132,14,11,0,2019
"560",560,"UNIVERSITY OF CALIFORNIA COLLEGE OF THE LAW, SAN FRANCISCO",62,4,80,13,1,0,160,165,129,195,1,325,63,96,1,2019
"561",561,"UNIVERSITY OF ILLINOIS CHICAGO SCHOOL OF LAW",48,1,30,41,0,30,150,208,130,219,9,358,37,106,7,2019
"562",562,"UNIVERSITY OF MASSACHUSETTS DARTMOUTH",10,0,5,9,0,5,29,81,54,56,0,110,14,15,0,2019
"563",563,"UNIVERSITY OF NEVADA - LAS VEGAS",23,0,5,7,0,7,42,76,54,64,0,118,19,23,0,2019
"564",564,"UTAH, UNIVERSITY OF",6,2,6,2,1,0,17,84,48,53,0,101,7,10,0,2019
"565",565,"VANDERBILT UNIVERSITY",8,1,12,16,0,1,38,129,88,79,0,167,16,22,0,2019
"566",566,"VERMONT LAW SCHOOL",17,0,5,21,1,0,44,95,66,71,2,139,19,23,2,2019
"567",567,"VILLANOVA UNIVERSITY",13,0,5,13,0,3,34,140,78,96,0,174,11,23,0,2019
"568",568,"VIRGINIA, UNIVERSITY OF",22,0,24,18,0,9,73,249,173,149,0,322,41,32,0,2019
"569",569,"WAKE FOREST UNIVERSITY",19,1,7,20,0,7,54,156,92,117,1,210,20,33,1,2019
"570",570,"WASHBURN UNIVERSITY",8,1,2,6,0,5,22,76,48,50,0,98,12,10,0,2019
"571",571,"WASHINGTON AND LEE UNIVERSITY",7,2,6,11,0,3,29,67,48,48,0,96,13,16,0,2019
"572",572,"WASHINGTON UNIVERSITY",8,0,14,18,0,4,44,155,94,105,0,199,23,21,0,2019
"573",573,"WASHINGTON, UNIVERSITY OF",17,0,12,2,0,8,39,110,55,91,3,149,15,24,0,2019
"574",574,"WAYNE STATE UNIVERSITY",0,2,3,12,0,2,19,92,56,55,0,111,9,10,0,2019
"575",575,"WEST VIRGINIA UNIVERSITY",3,0,2,2,0,4,11,104,54,61,0,115,4,7,0,2019
"576",576,"COOLEY LAW SCHOOL",19,1,17,117,2,72,228,268,180,316,0,496,67,161,0,2019
"577",577,"WESTERN NEW ENGLAND UNIVERSITY",4,1,4,13,0,1,23,75,50,48,0,98,8,15,0,2019
"578",578,"WESTERN STATE COLLEGE OF LAW",7,0,5,0,0,1,13,9,12,10,0,22,8,5,0,2019
"579",579,"WIDENER UNIVERSITY-DELAWARE",21,0,6,17,0,6,50,173,98,125,0,223,18,32,0,2019
"580",580,"WIDENER-COMMONWEALTH",10,0,6,18,0,0,34,76,50,60,0,110,13,21,0,2019
"581",581,"WILLAMETTE UNIVERSITY",15,1,10,1,1,2,30,87,52,65,0,117,15,15,0,2019
"582",582,"WILLIAM AND MARY LAW SCHOOL",6,0,10,7,0,9,32,186,112,106,0,218,15,17,0,2019
"583",583,"WISCONSIN, UNIVERSITY OF",23,0,5,9,0,13,50,163,100,113,0,213,23,27,0,2019
"584",584,"WYOMING, UNIVERSITY OF",9,3,1,1,0,0,14,54,36,32,0,68,3,11,0,2019
"585",585,"YALE UNIVERSITY",33,1,32,15,0,17,98,105,93,108,2,203,41,56,1,2019
"586",586,"AKRON, UNIVERSITY OF",4,1,9,17,0,0,31,110,70,71,0,141,17,14,0,2020
"587",587,"ALABAMA, UNIVERSITY OF",8,0,1,13,0,4,26,98,61,62,1,124,12,13,1,2020
"588",588,"ALBANY LAW SCHOOL",16,0,11,6,0,2,35,140,87,88,0,175,12,23,0,2020
"589",589,"AMERICAN UNIVERSITY",55,1,28,28,0,27,139,205,107,237,0,344,41,98,0,2020
"590",590,"APPALACHIAN SCHOOL OF LAW",6,0,4,4,0,0,14,51,39,26,0,65,7,7,0,2020
"591",591,"ARIZONA STATE UNIVERSITY",33,6,8,4,1,22,74,150,119,105,0,224,43,31,0,2020
"592",592,"ARIZONA, UNIVERSITY OF",15,7,8,2,0,1,33,81,58,56,0,114,17,16,0,2020
"593",593,"ARKANSAS, FAYETTEVILLE, UNIVERSITY OF",11,1,1,7,0,5,25,104,65,64,0,129,13,12,0,2020
"594",594,"ARKANSAS, LITTLE ROCK, UNIVERSITY OF",14,0,4,8,0,0,26,131,74,83,0,157,10,16,0,2020
"595",595,"ATLANTA'S JOHN MARSHALL LAW SCHOOL",18,5,6,55,1,0,85,39,54,70,0,124,30,55,0,2020
"596",596,"AVE MARIA SCHOOL OF LAW",22,0,1,5,0,0,28,85,54,59,0,113,8,20,0,2020
"597",597,"BALTIMORE, UNIVERSITY OF",30,0,17,43,0,18,108,162,102,166,2,270,33,73,2,2020
"598",598,"BARRY UNIVERSITY",80,5,14,46,0,0,145,97,92,150,0,242,52,93,0,2020
"599",599,"BAYLOR UNIVERSITY",29,3,7,2,0,2,43,104,72,75,0,147,20,23,0,2020
"600",600,"BELMONT UNIVERSITY",10,0,2,4,0,4,20,100,41,79,0,120,4,16,0,2020
"601",601,"BOSTON COLLEGE",14,0,25,14,0,9,62,176,124,114,0,238,31,31,0,2020
"602",602,"BOSTON UNIVERSITY",33,0,20,9,0,11,73,158,106,125,0,231,24,49,0,2020
"603",603,"BRIGHAM YOUNG UNIVERSITY",10,1,4,0,2,2,19,93,66,46,0,112,11,8,0,2020
"604",604,"BROOKLYN LAW SCHOOL",42,0,44,18,0,19,123,253,150,225,1,376,37,85,1,2020
"605",605,"CALIFORNIA WESTERN SCHOOL OF LAW",64,2,16,6,4,16,108,109,84,133,0,217,42,66,0,2020
"606",606,"CALIFORNIA-BERKELEY, UNIVERSITY OF",44,2,59,25,0,35,165,160,116,208,1,325,45,120,0,2020
"607",607,"CALIFORNIA-DAVIS, UNIVERSITY OF",31,0,42,3,0,14,90,93,52,130,1,183,23,66,1,2020
"608",608,"CALIFORNIA-IRVINE, UNIVERSITY OF",23,0,29,10,0,13,75,63,50,86,2,138,24,49,2,2020
"609",609,"CALIFORNIA-LOS ANGELES, UNIVERSITY OF",46,1,33,18,0,21,119,178,135,160,2,297,50,68,1,2020
"610",610,"CAMPBELL UNIVERSITY",15,0,2,9,0,4,30,148,80,98,0,178,15,15,0,2020
"611",611,"CAPITAL UNIVERSITY",6,1,3,11,0,11,32,139,88,83,0,171,18,14,0,2020
"612",612,"CARDOZO SCHOOL OF LAW",30,0,33,10,0,9,82,206,120,167,1,288,26,56,0,2020
"613",613,"CASE WESTERN RESERVE UNIVERSITY",5,0,5,10,0,2,22,83,53,52,0,105,12,10,0,2020
"614",614,"CATHOLIC UNIVERSITY OF AMERICA",14,0,7,6,1,1,29,82,46,65,0,111,9,20,0,2020
"615",615,"CHAPMAN UNIVERSITY",30,0,30,4,0,8,72,68,65,75,0,140,32,40,0,2020
"616",616,"CHARLESTON SCHOOL OF LAW",8,1,1,10,0,7,27,155,86,96,0,182,15,12,0,2020
"617",617,"CHICAGO, UNIVERSITY OF",37,0,24,15,0,5,81,99,93,86,1,180,46,34,1,2020
"618",618,"CHICAGO-KENT COLLEGE OF LAW-IIT",33,0,10,21,0,12,76,145,101,118,2,221,34,42,0,2020
"619",619,"CINCINNATI, UNIVERSITY OF",6,0,6,7,0,0,19,111,61,68,1,130,5,13,1,2020
"620",620,"CITY UNIVERSITY OF NEW YORK",65,0,23,13,1,12,114,94,61,144,3,208,32,81,1,2020
"621",621,"CLEVELAND STATE UNIVERSITY",5,1,3,15,0,0,24,110,66,68,0,134,10,14,0,2020
"622",622,"COLORADO, UNIVERSITY OF",39,3,5,5,0,13,65,112,89,86,2,177,28,36,1,2020
"623",623,"COLUMBIA UNIVERSITY",26,1,58,36,0,12,133,202,165,169,1,335,52,81,0,2020
"624",624,"CONNECTICUT, UNIVERSITY OF",18,1,13,6,0,3,41,113,66,88,0,154,18,23,0,2020
"625",625,"CORNELL UNIVERSITY",22,0,25,12,0,17,76,77,80,73,0,153,34,42,0,2020
"626",626,"CREIGHTON UNIVERSITY",21,0,0,4,0,3,28,100,70,58,0,128,16,12,0,2020
"627",627,"DAYTON, UNIVERSITY OF",10,1,6,11,0,13,41,120,75,83,3,161,18,20,3,2020
"628",628,"DENVER, UNIVERSITY OF",39,2,7,6,2,17,73,184,100,157,0,257,27,46,0,2020
"629",629,"DEPAUL UNIVERSITY",20,1,13,17,0,8,59,119,79,98,1,178,22,36,1,2020
"630",630,"DETROIT MERCY, UNIVERSITY OF",4,0,7,17,0,6,34,75,50,59,0,109,16,18,0,2020
"631",631,"DISTRICT OF COLUMBIA",13,0,8,32,0,1,54,17,32,39,0,71,22,32,0,2020
"632",632,"DRAKE UNIVERSITY",5,0,2,5,0,1,13,89,53,49,0,102,6,7,0,2020
"633",633,"DREXEL UNIVERSITY",17,0,9,10,0,7,43,119,59,103,0,162,13,30,0,2020
"634",634,"DUKE UNIVERSITY",20,1,18,15,0,11,65,155,94,120,6,220,23,40,2,2020
"635",635,"DUQUESNE UNIVERSITY",18,0,6,9,0,3,36,123,85,73,1,159,15,20,1,2020
"636",636,"ELON UNIVERSITY",9,4,7,29,0,0,49,110,63,96,0,159,11,38,0,2020
"637",637,"EMORY UNIVERSITY",14,0,18,20,0,7,59,170,102,127,0,229,20,39,0,2020
"638",638,"FAULKNER UNIVERSITY",2,1,0,10,0,1,14,49,27,36,0,63,3,11,0,2020
"639",639,"FLORIDA A&M UNIVERSITY",17,0,2,57,0,15,91,21,39,73,0,112,26,65,0,2020
"640",640,"FLORIDA INTERNATIONAL UNIVERSITY",87,0,2,13,0,4,106,46,71,81,0,152,42,64,0,2020
"641",641,"FLORIDA STATE UNIVERSITY",28,1,2,12,0,10,53,112,70,95,0,165,21,32,0,2020
"642",642,"FLORIDA, UNIVERSITY OF",41,0,1,13,1,9,65,134,99,100,0,199,35,30,0,2020
"643",643,"FORDHAM UNIVERSITY",46,0,41,37,0,17,141,237,169,209,0,378,59,82,0,2020
"644",644,"GEORGE MASON UNIVERSITY",9,0,8,2,1,8,28,110,71,67,0,138,15,13,0,2020
"645",645,"GEORGE WASHINGTON UNIVERSITY",18,4,75,43,0,4,144,328,200,271,1,472,60,84,0,2020
"646",646,"GEORGETOWN UNIVERSITY",38,0,45,62,0,23,168,383,232,317,2,551,57,111,0,2020
"647",647,"GEORGIA STATE UNIVERSITY",22,0,18,34,0,3,77,132,89,120,0,209,26,51,0,2020
"648",648,"GEORGIA, UNIVERSITY OF",7,1,12,18,0,0,38,133,85,86,0,171,14,24,0,2020
"649",649,"GOLDEN GATE UNIVERSITY",48,0,21,6,1,12,88,48,59,77,0,136,38,50,0,2020
"650",650,"GONZAGA UNIVERSITY",22,1,4,2,0,12,41,110,74,73,4,151,20,20,1,2020
"651",651,"HARVARD UNIVERSITY",56,1,74,44,1,25,201,259,230,225,5,460,91,106,4,2020
"652",652,"HAWAII, UNIVERSITY OF",12,0,30,2,2,33,79,22,49,52,0,101,37,42,0,2020
"653",653,"HOFSTRA UNIVERSITY",30,2,16,11,1,1,61,184,118,127,0,245,23,38,0,2020
"654",654,"HOUSTON, UNIVERSITY OF",36,0,26,11,0,7,80,149,108,121,0,229,27,53,0,2020
"655",655,"HOWARD UNIVERSITY",5,0,1,108,0,29,143,6,45,104,0,149,43,100,0,2020
"656",656,"IDAHO, UNIVERSITY OF",3,4,1,3,1,11,23,102,71,54,0,125,10,13,0,2020
"657",657,"ILLINOIS, UNIVERSITY OF",20,0,21,9,0,6,56,83,70,69,0,139,24,32,0,2020
"658",658,"INDIANA UNIVERSITY - BLOOMINGTON",13,0,7,11,0,2,33,139,91,81,0,172,13,20,0,2020
"659",659,"INDIANA UNIVERSITY - INDIANAPOLIS",22,0,4,12,0,7,45,242,129,158,0,287,15,30,0,2020
"660",660,"INTER AMERICAN UNIVERSITY OF PUERTO RICO",148,0,0,0,0,0,148,2,60,89,1,150,59,88,1,2020
"661",661,"IOWA, UNIVERSITY OF",19,0,7,8,0,8,42,109,67,84,0,151,14,28,0,2020
"662",662,"KANSAS, UNIVERSITY OF",14,1,3,2,0,7,27,71,50,48,0,98,11,16,0,2020
"663",663,"KENTUCKY, UNIVERSITY OF",9,0,6,11,0,0,26,107,72,61,0,133,15,11,0,2020
"664",664,"LEWIS AND CLARK COLLEGE",25,1,16,3,0,5,50,129,69,110,0,179,17,33,0,2020
"665",665,"LIBERTY UNIVERSITY",12,0,4,8,0,6,30,75,60,45,0,105,12,18,0,2020
"666",666,"LINCOLN MEMORIAL",5,0,2,5,0,8,20,98,60,58,0,118,7,13,0,2020
"667",667,"LOUISIANA STATE UNIVERSITY",11,0,5,18,0,6,40,164,96,108,0,204,19,21,0,2020
"668",668,"LOUISVILLE, UNIVERSITY OF",6,0,4,6,0,3,19,93,48,64,0,112,8,11,0,2020
"669",669,"LOYOLA MARYMOUNT UNIVERSITY-LOS ANGELES",79,2,36,6,0,21,144,165,123,184,2,309,46,97,1,2020
"670",670,"LOYOLA UNIVERSITY-CHICAGO",35,1,16,7,0,6,65,184,96,153,0,249,24,41,0,2020
"671",671,"LOYOLA UNIVERSITY-NEW ORLEANS",25,1,7,30,0,5,68,132,89,109,2,200,31,37,0,2020
"672",672,"MAINE, UNIVERSITY OF",6,1,2,2,0,0,11,74,42,43,0,85,8,3,0,2020
"673",673,"MARQUETTE UNIVERSITY",18,0,7,9,1,6,41,149,95,95,0,190,14,27,0,2020
"674",674,"MARYLAND, UNIVERSITY OF",24,0,12,26,0,7,69,135,76,127,1,204,22,47,0,2020
"675",675,"MCGEORGE SCHOOL OF LAW",29,0,24,4,0,22,79,88,68,98,1,167,34,44,1,2020
"676",676,"MEMPHIS, UNIVERSITY OF",8,0,4,19,0,0,31,84,54,60,1,115,13,17,1,2020
"677",677,"MERCER UNIVERSITY",10,0,1,17,0,3,31,106,63,74,0,137,14,17,0,2020
"678",678,"MIAMI, UNIVERSITY OF",134,0,8,22,0,15,179,157,152,184,0,336,71,108,0,2020
"679",679,"MICHIGAN STATE UNIVERSITY",6,2,8,10,0,11,37,144,99,82,0,181,20,17,0,2020
"680",680,"MICHIGAN, UNIVERSITY OF",23,3,40,14,0,29,109,191,148,152,0,300,53,56,0,2020
"681",681,"MINNESOTA, UNIVERSITY OF",24,2,10,9,0,9,54,147,92,109,0,201,26,28,0,2020
"682",682,"MISSISSIPPI COLLEGE",7,0,5,14,0,0,26,122,78,70,0,148,12,14,0,2020
"683",683,"MISSISSIPPI, UNIVERSITY OF",5,2,1,22,1,0,31,129,81,79,0,160,12,19,0,2020
"684",684,"MISSOURI, UNIVERSITY OF",5,1,4,8,0,0,18,99,61,56,0,117,6,12,0,2020
"685",685,"MISSOURI-KANSAS CITY, UNIVERSITY OF",14,0,4,10,0,6,34,113,67,80,0,147,13,21,0,2020
"686",686,"MITCHELL | HAMLINE",25,3,19,29,2,8,86,283,166,197,6,369,33,52,1,2020
"687",687,"MONTANA, UNIVERSITY OF",3,3,4,0,0,8,18,66,42,42,0,84,8,10,0,2020
"688",688,"NEBRASKA, UNIVERSITY OF",5,1,4,1,0,0,11,123,70,64,0,134,5,6,0,2020
"689",689,"NEW ENGLAND LAW | BOSTON",39,1,17,27,0,5,89,276,124,241,0,365,24,65,0,2020
"690",690,"NEW HAMPSHIRE, UNIVERSITY OF",16,0,13,8,0,7,44,141,111,74,0,185,25,19,0,2020
"691",691,"NEW MEXICO, UNIVERSITY OF",27,8,3,6,0,1,45,52,44,52,1,97,19,26,0,2020
"692",692,"NEW YORK LAW SCHOOL",33,1,22,19,0,9,84,217,118,183,0,301,28,56,0,2020
"693",693,"NEW YORK UNIVERSITY",49,0,50,36,0,26,161,248,184,221,4,409,52,107,2,2020
"694",694,"NORTH CAROLINA CENTRAL UNIVERSITY",11,1,5,94,4,0,115,51,51,115,0,166,32,83,0,2020
"695",695,"NORTH CAROLINA, UNIVERSITY OF",18,1,13,12,0,6,50,129,81,97,1,179,16,33,1,2020
"696",696,"NORTH DAKOTA, UNIVERSITY OF",8,1,2,1,0,7,19,46,33,32,0,65,8,11,0,2020
"697",697,"NORTHEASTERN UNIVERSITY SCHOOL OF LAW",23,0,22,17,0,15,77,124,51,147,3,201,15,61,1,2020
"698",698,"NORTHERN ILLINOIS UNIVERSITY",19,0,2,12,0,3,36,88,63,61,0,124,20,16,0,2020
"699",699,"NORTHERN KENTUCKY UNIVERSITY",3,0,3,10,0,0,16,111,78,49,0,127,8,8,0,2020
"700",700,"NORTHWESTERN UNIVERSITY",29,0,29,14,0,12,84,139,105,112,6,223,36,47,1,2020
"701",701,"NOTRE DAME, UNIVERSITY OF",18,0,6,6,0,4,34,114,78,70,0,148,21,13,0,2020
"702",702,"NOVA SOUTHEASTERN UNIVERSITY",64,0,7,12,0,3,86,101,92,94,1,187,33,53,0,2020
"703",703,"OHIO NORTHERN UNIVERSITY",5,0,3,3,0,1,12,46,35,23,0,58,9,3,0,2020
"704",704,"OHIO STATE UNIVERSITY",15,1,7,19,0,3,45,130,70,105,0,175,16,29,0,2020
"705",705,"OKLAHOMA CITY UNIVERSITY",37,6,5,11,0,11,70,98,63,105,0,168,21,49,0,2020
"706",706,"OKLAHOMA, UNIVERSITY OF",14,4,5,10,0,29,62,106,79,88,1,168,30,32,0,2020
"707",707,"OREGON, UNIVERSITY OF",20,4,10,5,0,8,47,109,79,77,0,156,22,25,0,2020
"708",708,"PACE UNIVERSITY",23,0,21,13,0,19,76,160,91,145,0,236,21,55,0,2020
"709",709,"PENNSYLVANIA STATE - DICKINSON LAW",9,0,9,9,1,6,34,41,33,42,0,75,14,20,0,2020
"710",710,"PENNSYLVANIA STATE - PENN STATE LAW",14,0,4,6,0,6,30,85,51,64,0,115,7,23,0,2020
"711",711,"PENNSYLVANIA, UNIVERSITY OF",22,1,28,22,0,14,87,137,111,113,0,224,37,50,0,2020
"712",712,"PEPPERDINE UNIVERSITY",23,0,21,8,0,6,58,116,79,95,0,174,24,34,0,2020
"713",713,"PITTSBURGH, UNIVERSITY OF",8,0,3,9,0,4,24,98,52,70,0,122,11,13,0,2020
"714",714,"PONTIFICAL CATHOLIC UNIVERSITY OF P.R.",172,0,0,0,0,0,172,0,78,94,0,172,78,94,0,2020
"715",715,"PUERTO RICO, UNIVERSITY OF",96,0,0,0,0,40,136,1,50,87,0,137,50,86,0,2020
"716",716,"QUINNIPIAC UNIVERSITY",11,0,0,6,0,3,20,114,56,78,0,134,3,17,0,2020
"717",717,"REGENT UNIVERSITY",8,1,3,6,0,1,19,81,49,51,0,100,6,13,0,2020
"718",718,"RICHMOND, UNIVERSITY OF",18,0,11,8,0,5,42,106,66,81,1,148,15,27,0,2020
"719",719,"ROGER WILLIAMS UNIVERSITY",22,0,6,14,0,5,47,130,86,90,1,177,15,31,1,2020
"720",720,"RUTGERS UNIVERSITY",57,3,34,49,0,0,143,243,199,182,5,386,58,84,1,2020
"721",721,"SAINT LOUIS UNIVERSITY",10,0,11,20,0,8,49,141,80,108,2,190,17,31,1,2020
"722",722,"SAMFORD UNIVERSITY",6,1,0,13,0,1,21,127,63,85,0,148,6,15,0,2020
"723",723,"SAN DIEGO, UNIVERSITY OF",34,0,27,5,0,15,81,157,104,134,0,238,38,43,0,2020
"724",724,"SAN FRANCISCO, UNIVERSITY OF",23,0,22,8,0,4,57,47,40,63,1,104,17,40,0,2020
"725",725,"SANTA CLARA UNIVERSITY",64,1,60,7,1,19,152,122,123,151,0,274,60,92,0,2020
"726",726,"SEATTLE UNIVERSITY",21,4,25,7,1,26,84,122,70,136,0,206,26,58,0,2020
"727",727,"SETON HALL UNIVERSITY",30,1,13,8,2,9,63,177,119,121,0,240,27,36,0,2020
"728",728,"SOUTH CAROLINA, UNIVERSITY OF",5,2,4,19,0,7,37,168,95,110,0,205,11,26,0,2020
"729",729,"SOUTH DAKOTA, UNIVERSITY OF",2,1,0,1,0,5,9,52,31,30,0,61,4,5,0,2020
"730",730,"SOUTH TEXAS COLLEGE OF LAW HOUSTON",144,0,46,39,0,9,238,272,228,282,0,510,84,154,0,2020
"731",731,"SOUTHERN CALIFORNIA, UNIVERSITY OF",23,0,37,18,0,9,87,92,71,108,0,179,32,55,0,2020
"732",732,"SOUTHERN ILLINOIS UNIVERSITY-CARBONDALE",1,0,3,7,0,1,12,80,51,41,0,92,3,9,0,2020
"733",733,"SOUTHERN METHODIST UNIVERSITY",33,0,9,14,0,10,66,135,97,103,1,201,27,39,0,2020
"734",734,"SOUTHERN UNIVERSITY",33,1,1,231,0,1,267,79,131,214,1,346,86,180,1,2020
"735",735,"SOUTHWESTERN LAW SCHOOL",91,0,29,17,0,21,158,161,125,194,0,319,52,106,0,2020
"736",736,"ST. JOHN'S UNIVERSITY",34,0,17,15,0,4,70,167,125,112,0,237,28,42,0,2020
"737",737,"ST. MARY'S UNIVERSITY",140,0,5,10,0,0,155,106,119,142,0,261,70,85,0,2020
"738",738,"ST. THOMAS UNIVERSITY (FLORIDA)",178,0,7,17,0,1,203,42,92,153,0,245,70,133,0,2020
"739",739,"ST. THOMAS, UNIVERSITY OF (MINNESOTA)",14,0,4,6,0,3,27,123,56,94,0,150,10,17,0,2020
"740",740,"STANFORD UNIVERSITY",32,0,17,17,0,11,77,85,80,82,0,162,32,45,0,2020
"741",741,"STETSON UNIVERSITY",44,4,12,10,0,2,72,231,137,166,0,303,29,43,0,2020
"742",742,"SUFFOLK UNIVERSITY",33,0,19,13,1,9,75,307,133,249,0,382,24,51,0,2020
"743",743,"SYRACUSE UNIVERSITY",34,1,4,18,0,8,65,188,127,126,0,253,26,39,0,2020
"744",744,"TEMPLE UNIVERSITY",23,0,16,31,0,4,74,140,109,103,2,214,33,41,0,2020
"745",745,"TENNESSEE, UNIVERSITY OF",5,0,3,13,0,2,23,94,67,50,0,117,12,11,0,2020
"746",746,"TEXAS A&M UNIVERSITY",31,1,4,11,0,9,56,104,74,86,0,160,22,34,0,2020
"747",747,"TEXAS AT AUSTIN, UNIVERSITY OF",44,0,30,14,0,9,97,186,147,136,0,283,39,58,0,2020
"748",748,"TEXAS SOUTHERN UNIVERSITY THURGOOD MARSHALL SCHOOL OF LAW",54,1,9,96,0,0,160,25,72,113,0,185,55,105,0,2020
"749",749,"TEXAS TECH UNIVERSITY",14,0,3,8,0,30,55,100,84,71,0,155,37,18,0,2020
"750",750,"TOLEDO, UNIVERSITY OF",4,0,8,5,0,3,20,101,48,73,0,121,8,12,0,2020
"751",751,"TOURO UNIVERSITY",42,2,26,17,0,0,87,113,109,91,0,200,42,45,0,2020
"752",752,"TULANE UNIVERSITY",25,0,1,14,0,6,46,160,102,104,0,206,20,26,0,2020
"753",753,"TULSA, UNIVERSITY OF",3,3,2,4,0,15,27,100,61,66,0,127,12,15,0,2020
"754",754,"UNIVERSITY OF BUFFALO-SUNY",14,0,4,5,0,5,28,124,66,86,0,152,11,17,0,2020
"755",755,"UNIVERSITY OF CALIFORNIA COLLEGE OF THE LAW, SAN FRANCISCO",67,1,105,14,4,0,191,161,133,216,3,352,59,131,1,2020
"756",756,"UNIVERSITY OF ILLINOIS CHICAGO SCHOOL OF LAW",48,1,24,42,0,11,126,227,151,201,1,353,43,82,1,2020
"757",757,"UNIVERSITY OF MASSACHUSETTS DARTMOUTH",23,1,10,11,0,6,51,101,63,89,0,152,20,31,0,2020
"758",758,"UNIVERSITY OF NEVADA - LAS VEGAS",23,1,7,6,0,1,38,79,56,61,0,117,17,21,0,2020
"759",759,"UTAH, UNIVERSITY OF",6,1,3,1,0,0,11,77,39,47,2,88,6,5,0,2020
"760",760,"VANDERBILT UNIVERSITY",13,0,11,13,1,0,38,134,68,104,0,172,11,27,0,2020
"761",761,"VERMONT LAW SCHOOL",18,0,6,11,0,0,35,88,39,83,1,123,7,27,1,2020
"762",762,"VILLANOVA UNIVERSITY",4,0,7,8,0,6,25,149,72,102,0,174,11,14,0,2020
"763",763,"VIRGINIA, UNIVERSITY OF",19,0,35,18,0,10,82,206,140,147,1,288,39,43,0,2020
"764",764,"WAKE FOREST UNIVERSITY",10,0,2,7,0,7,26,60,39,47,0,86,11,15,0,2020
"765",765,"WASHBURN UNIVERSITY",6,0,2,8,0,7,23,84,53,54,0,107,10,13,0,2020
"766",766,"WASHINGTON AND LEE UNIVERSITY",7,1,10,8,0,1,27,84,59,52,0,111,15,12,0,2020
"767",767,"WASHINGTON UNIVERSITY",9,0,18,14,0,7,48,164,119,93,0,212,21,27,0,2020
"768",768,"WASHINGTON, UNIVERSITY OF",15,2,21,8,3,10,59,97,47,108,1,156,18,41,0,2020
"769",769,"WAYNE STATE UNIVERSITY",5,3,2,12,0,1,23,93,42,74,0,116,6,17,0,2020
"770",770,"WEST VIRGINIA UNIVERSITY",3,0,0,3,0,3,9,102,63,48,0,111,5,4,0,2020
"771",771,"COOLEY LAW SCHOOL",12,1,13,48,1,36,111,169,120,160,0,280,32,79,0,2020
"772",772,"WESTERN NEW ENGLAND UNIVERSITY",19,0,4,14,0,0,37,84,43,78,0,121,13,24,0,2020
"773",773,"WESTERN STATE COLLEGE OF LAW",30,0,6,3,1,9,49,34,37,46,0,83,23,26,0,2020
"774",774,"WIDENER UNIVERSITY-DELAWARE",16,0,8,33,0,9,66,175,109,131,1,241,27,39,0,2020
"775",775,"WIDENER-COMMONWEALTH",13,0,5,16,0,0,34,77,41,70,0,111,17,17,0,2020
"776",776,"WILLAMETTE UNIVERSITY",19,5,6,3,4,0,37,76,56,56,1,113,19,18,0,2020
"777",777,"WILLIAM AND MARY LAW SCHOOL",5,0,14,4,0,7,30,180,99,111,0,210,15,15,0,2020
"778",778,"WISCONSIN, UNIVERSITY OF",25,3,8,10,1,15,62,172,131,103,0,234,36,26,0,2020
"779",779,"WYOMING, UNIVERSITY OF",8,1,0,0,0,0,9,66,39,36,0,75,3,6,0,2020
"780",780,"YALE UNIVERSITY",37,2,32,16,1,19,107,99,103,101,2,206,49,58,0,2020
"781",781,"AKRON, UNIVERSITY OF",6,1,6,14,0,5,32,127,77,81,1,159,13,19,0,2021
"782",782,"ALABAMA, UNIVERSITY OF",6,0,4,16,0,5,31,118,73,76,0,149,12,19,0,2021
"783",783,"ALBANY LAW SCHOOL",14,1,13,13,0,4,45,162,90,117,0,207,15,30,0,2021
"784",784,"AMERICAN UNIVERSITY",62,1,31,19,3,22,138,243,136,245,0,381,52,86,0,2021
"785",785,"APPALACHIAN SCHOOL OF LAW",3,2,1,7,0,0,13,44,29,28,0,57,5,8,0,2021
"786",786,"ARIZONA STATE UNIVERSITY",32,6,19,13,1,20,91,202,153,138,2,293,46,45,0,2021
"787",787,"ARIZONA, UNIVERSITY OF",20,7,5,4,0,6,42,85,56,71,0,127,18,24,0,2021
"788",788,"ARKANSAS, FAYETTEVILLE, UNIVERSITY OF",9,1,3,9,0,10,32,94,63,63,0,126,19,13,0,2021
"789",789,"ARKANSAS, LITTLE ROCK, UNIVERSITY OF",3,2,2,15,0,0,22,134,70,86,0,156,8,14,0,2021
"790",790,"ATLANTA'S JOHN MARSHALL LAW SCHOOL",17,4,9,52,0,0,82,40,45,77,0,122,28,54,0,2021
"791",791,"AVE MARIA SCHOOL OF LAW",23,0,1,5,0,2,31,82,55,58,0,113,10,21,0,2021
"792",792,"BALTIMORE, UNIVERSITY OF",30,0,15,40,0,15,100,183,116,165,2,283,38,61,1,2021
"793",793,"BARRY UNIVERSITY",94,2,14,44,0,15,169,135,122,182,0,304,64,105,0,2021
"794",794,"BAYLOR UNIVERSITY",37,0,5,9,0,12,63,146,92,117,0,209,28,35,0,2021
"795",795,"BELMONT UNIVERSITY",3,0,1,9,0,8,21,115,48,87,1,136,7,14,0,2021
"796",796,"BOSTON COLLEGE",6,2,25,35,0,31,99,234,147,186,0,333,41,58,0,2021
"797",797,"BOSTON UNIVERSITY",53,0,28,16,0,20,117,178,135,160,0,295,41,76,0,2021
"798",798,"BRIGHAM YOUNG UNIVERSITY",10,0,8,3,4,1,26,102,63,65,0,128,13,13,0,2021
"799",799,"BROOKLYN LAW SCHOOL",43,1,41,14,0,15,114,286,155,237,8,400,42,69,3,2021
"800",800,"CALIFORNIA WESTERN SCHOOL OF LAW",54,1,14,7,0,11,87,115,80,122,0,202,27,60,0,2021
"801",801,"CALIFORNIA-BERKELEY, UNIVERSITY OF",71,1,55,27,0,29,183,171,131,214,9,354,64,117,2,2021
"802",802,"CALIFORNIA-DAVIS, UNIVERSITY OF",42,0,52,4,0,30,128,119,104,143,0,247,47,81,0,2021
"803",803,"CALIFORNIA-IRVINE, UNIVERSITY OF",24,0,32,11,1,15,83,71,71,81,2,154,38,44,1,2021
"804",804,"CALIFORNIA-LOS ANGELES, UNIVERSITY OF",51,1,54,12,0,32,150,197,148,197,2,347,59,90,1,2021
"805",805,"CAMPBELL UNIVERSITY",22,0,5,10,0,5,42,174,84,132,0,216,13,29,0,2021
"806",806,"CAPITAL UNIVERSITY",5,2,6,10,0,8,31,155,75,111,0,186,10,21,0,2021
"807",807,"CARDOZO SCHOOL OF LAW",31,0,23,11,0,7,72,210,103,175,4,282,18,53,1,2021
"808",808,"CASE WESTERN RESERVE UNIVERSITY",7,1,7,10,0,3,28,123,61,90,0,151,2,26,0,2021
"809",809,"CATHOLIC UNIVERSITY OF AMERICA",6,0,5,13,1,17,42,108,58,92,0,150,17,25,0,2021
"810",810,"CHAPMAN UNIVERSITY",33,0,24,11,0,9,77,69,67,79,0,146,31,46,0,2021
"811",811,"CHARLESTON SCHOOL OF LAW",13,1,4,13,0,0,31,211,80,162,0,242,10,21,0,2021
"812",812,"CHICAGO, UNIVERSITY OF",30,1,15,14,0,15,75,105,89,91,0,180,35,40,0,2021
"813",813,"CHICAGO-KENT COLLEGE OF LAW-IIT",33,0,22,21,0,12,88,150,94,143,1,238,26,62,0,2021
"814",814,"CINCINNATI, UNIVERSITY OF",4,0,5,4,2,2,17,106,58,65,0,123,7,10,0,2021
"815",815,"CITY UNIVERSITY OF NEW YORK",55,2,25,26,0,7,115,91,59,142,5,206,31,83,1,2021
"816",816,"CLEVELAND STATE UNIVERSITY",1,0,0,18,0,5,24,104,55,73,0,128,10,14,0,2021
"817",817,"COLORADO, UNIVERSITY OF",21,2,3,8,1,19,54,113,75,92,0,167,23,31,0,2021
"818",818,"COLUMBIA UNIVERSITY",36,1,57,54,0,4,152,252,204,195,5,404,56,95,1,2021
"819",819,"CONNECTICUT, UNIVERSITY OF",13,1,9,13,0,3,39,108,56,90,1,147,16,23,0,2021
"820",820,"CORNELL UNIVERSITY",22,0,21,10,1,9,63,100,80,83,0,163,25,38,0,2021
"821",821,"CREIGHTON UNIVERSITY",16,2,4,8,0,3,33,119,76,76,0,152,18,15,0,2021
"822",822,"DAYTON, UNIVERSITY OF",16,0,7,17,0,4,44,83,43,81,3,127,16,28,0,2021
"823",823,"DENVER, UNIVERSITY OF",26,3,5,7,0,11,52,189,80,160,1,241,18,33,1,2021
"824",824,"DEPAUL UNIVERSITY",33,0,11,14,0,11,69,146,73,140,2,215,18,50,1,2021
"825",825,"DETROIT MERCY, UNIVERSITY OF",9,0,10,11,0,7,37,109,58,88,0,146,13,24,0,2021
"826",826,"DISTRICT OF COLUMBIA",10,0,6,38,0,0,54,22,25,51,0,76,13,41,0,2021
"827",827,"DRAKE UNIVERSITY",5,0,2,4,0,1,12,110,58,64,0,122,8,4,0,2021
"828",828,"DREXEL UNIVERSITY",13,0,15,11,0,8,47,91,61,76,1,138,17,30,0,2021
"829",829,"DUKE UNIVERSITY",26,0,28,20,0,7,81,174,112,143,0,255,30,51,0,2021
"830",830,"DUQUESNE UNIVERSITY",7,0,5,5,0,2,19,133,62,90,0,152,6,13,0,2021
"831",831,"ELON UNIVERSITY",1,0,4,24,0,16,45,122,69,98,0,167,14,31,0,2021
"832",832,"EMORY UNIVERSITY",38,0,31,33,0,13,115,174,124,165,0,289,39,76,0,2021
"833",833,"FAULKNER UNIVERSITY",2,2,3,26,0,4,37,98,70,65,0,135,17,20,0,2021
"834",834,"FLORIDA A&M UNIVERSITY",34,0,1,60,0,3,98,31,36,93,0,129,26,72,0,2021
"835",835,"FLORIDA INTERNATIONAL UNIVERSITY",82,0,5,15,0,0,102,61,66,97,0,163,45,57,0,2021
"836",836,"FLORIDA STATE UNIVERSITY",41,0,5,9,0,8,63,91,62,92,0,154,25,38,0,2021
"837",837,"FLORIDA, UNIVERSITY OF",34,1,9,18,0,8,70,157,118,109,0,227,30,40,0,2021
"838",838,"FORDHAM UNIVERSITY",42,0,54,32,0,15,143,276,188,231,0,419,57,86,0,2021
"839",839,"GEORGE MASON UNIVERSITY",15,1,24,4,0,11,55,195,128,122,0,250,30,25,0,2021
"840",840,"GEORGE WASHINGTON UNIVERSITY",13,0,38,40,0,8,99,326,183,242,0,425,32,67,0,2021
"841",841,"GEORGETOWN UNIVERSITY",48,1,43,52,0,42,186,306,223,266,3,492,82,104,0,2021
"842",842,"GEORGIA STATE UNIVERSITY",27,1,13,34,0,9,84,153,100,137,0,237,23,61,0,2021
"843",843,"GEORGIA, UNIVERSITY OF",16,0,11,15,0,0,42,151,92,100,1,193,13,28,1,2021
"844",844,"GOLDEN GATE UNIVERSITY",42,1,17,7,6,7,80,58,49,87,2,138,28,51,1,2021
"845",845,"GONZAGA UNIVERSITY",28,0,8,1,0,15,52,138,79,109,2,190,22,30,0,2021
"846",846,"HARVARD UNIVERSITY",65,3,99,46,3,28,244,252,230,265,1,496,102,141,1,2021
"847",847,"HAWAII, UNIVERSITY OF",8,0,31,1,2,35,77,21,28,69,1,98,23,54,0,2021
"848",848,"HOFSTRA UNIVERSITY",27,2,11,17,1,2,60,186,112,134,0,246,17,43,0,2021
"849",849,"HOUSTON, UNIVERSITY OF",25,0,30,11,0,30,96,143,106,133,0,239,34,62,0,2021
"850",850,"HOWARD UNIVERSITY",7,0,3,138,0,15,163,0,42,120,1,163,42,120,1,2021
"851",851,"IDAHO, UNIVERSITY OF",13,4,3,2,1,5,28,98,70,56,0,126,18,10,0,2021
"852",852,"ILLINOIS, UNIVERSITY OF",23,1,28,7,1,3,63,104,93,74,0,167,33,30,0,2021
"853",853,"INDIANA UNIVERSITY - BLOOMINGTON",15,0,6,11,0,7,39,140,89,89,1,179,15,24,0,2021
"854",854,"INDIANA UNIVERSITY - INDIANAPOLIS",14,0,12,16,0,10,52,222,117,157,0,274,19,33,0,2021
"855",855,"INTER AMERICAN UNIVERSITY OF PUERTO RICO",146,0,0,0,0,1,147,0,56,90,1,147,56,90,1,2021
"856",856,"IOWA, UNIVERSITY OF",17,1,6,5,0,2,31,122,82,69,2,153,14,16,1,2021
"857",857,"KANSAS, UNIVERSITY OF",17,1,2,4,0,2,26,95,50,71,0,121,13,13,0,2021
"858",858,"KENTUCKY, UNIVERSITY OF",10,1,10,12,0,0,33,107,59,81,0,140,10,23,0,2021
"859",859,"LEWIS AND CLARK COLLEGE",15,0,15,3,0,3,36,154,73,117,0,190,10,26,0,2021
"860",860,"LIBERTY UNIVERSITY",8,2,4,5,0,4,23,99,68,54,0,122,12,11,0,2021
"861",861,"LINCOLN MEMORIAL",1,1,2,5,1,8,18,106,58,66,0,124,6,12,0,2021
"862",862,"LOUISIANA STATE UNIVERSITY",13,0,2,22,0,5,42,186,111,117,0,228,15,27,0,2021
"863",863,"LOUISVILLE, UNIVERSITY OF",11,0,1,6,0,7,25,108,73,60,0,133,9,16,0,2021
"864",864,"LOYOLA MARYMOUNT UNIVERSITY-LOS ANGELES",82,0,33,16,0,18,149,179,116,211,1,328,54,95,0,2021
"865",865,"LOYOLA UNIVERSITY-CHICAGO",46,1,40,34,0,20,141,234,130,244,1,375,55,86,0,2021
"866",866,"LOYOLA UNIVERSITY-NEW ORLEANS",15,1,13,20,0,1,50,141,85,105,1,191,22,28,0,2021
"867",867,"MAINE, UNIVERSITY OF",6,1,4,4,1,0,16,67,31,52,0,83,5,11,0,2021
"868",868,"MARQUETTE UNIVERSITY",22,1,5,8,0,5,41,164,98,107,0,205,24,17,0,2021
"869",869,"MARYLAND, UNIVERSITY OF",24,0,17,29,0,9,79,191,91,178,1,270,26,52,1,2021
"870",870,"MCGEORGE SCHOOL OF LAW",21,1,4,6,20,23,75,88,71,90,2,163,23,51,1,2021
"871",871,"MEMPHIS, UNIVERSITY OF",5,0,8,22,0,0,35,82,63,54,0,117,19,16,0,2021
"872",872,"MERCER UNIVERSITY",9,0,7,6,0,5,27,86,52,61,0,113,13,14,0,2021
"873",873,"MIAMI, UNIVERSITY OF",122,0,6,25,8,13,174,188,153,209,0,362,60,114,0,2021
"874",874,"MICHIGAN STATE UNIVERSITY",11,2,4,6,0,8,31,184,113,102,0,215,14,17,0,2021
"875",875,"MICHIGAN, UNIVERSITY OF",34,2,33,22,0,22,113,191,149,149,6,304,51,61,1,2021
"876",876,"MINNESOTA, UNIVERSITY OF",24,0,14,9,0,12,59,161,105,114,1,220,29,29,1,2021
"877",877,"MISSISSIPPI COLLEGE",6,0,3,13,0,0,22,90,40,72,0,112,7,15,0,2021
"878",878,"MISSISSIPPI, UNIVERSITY OF",15,2,2,24,0,4,47,132,84,95,0,179,14,33,0,2021
"879",879,"MISSOURI, UNIVERSITY OF",6,4,3,12,0,0,25,112,68,69,0,137,14,11,0,2021
"880",880,"MISSOURI-KANSAS CITY, UNIVERSITY OF",15,0,2,8,0,7,32,98,58,72,0,130,8,24,0,2021
"881",881,"MITCHELL | HAMLINE",28,7,10,36,0,10,91,279,142,226,2,370,33,56,2,2021
"882",882,"MONTANA, UNIVERSITY OF",6,5,1,1,0,1,14,66,36,44,0,80,5,9,0,2021
"883",883,"NEBRASKA, UNIVERSITY OF",8,1,7,7,0,0,23,136,80,79,0,159,10,13,0,2021
"884",884,"NEW ENGLAND LAW | BOSTON",46,0,12,21,0,7,86,277,132,229,2,363,32,54,0,2021
"885",885,"NEW HAMPSHIRE, UNIVERSITY OF",14,0,13,6,0,9,42,168,132,78,0,210,26,16,0,2021
"886",886,"NEW MEXICO, UNIVERSITY OF",42,4,1,2,0,3,52,52,45,59,0,104,23,29,0,2021
"887",887,"NEW YORK LAW SCHOOL",52,1,25,13,1,7,99,276,119,255,1,375,30,69,0,2021
"888",888,"NEW YORK UNIVERSITY",43,0,60,42,0,27,172,277,184,258,7,449,57,111,4,2021
"889",889,"NORTH CAROLINA CENTRAL UNIVERSITY",12,7,6,110,0,2,137,37,51,123,0,174,34,103,0,2021
"890",890,"NORTH CAROLINA, UNIVERSITY OF",23,1,13,12,0,8,57,147,89,112,3,204,21,35,1,2021
"891",891,"NORTH DAKOTA, UNIVERSITY OF",0,3,3,4,0,6,16,63,40,39,0,79,6,10,0,2021
"892",892,"NORTHEASTERN UNIVERSITY SCHOOL OF LAW",33,0,29,22,0,15,99,136,57,177,1,235,25,73,1,2021
"893",893,"NORTHERN ILLINOIS UNIVERSITY",10,0,11,9,0,15,45,74,57,62,0,119,19,26,0,2021
"894",894,"NORTHERN KENTUCKY UNIVERSITY",6,0,2,11,0,0,19,123,65,77,0,142,8,11,0,2021
"895",895,"NORTHWESTERN UNIVERSITY",28,0,29,31,2,19,109,116,100,124,1,225,32,76,1,2021
"896",896,"NOTRE DAME, UNIVERSITY OF",21,0,13,7,0,4,45,124,80,89,0,169,19,26,0,2021
"897",897,"NOVA SOUTHEASTERN UNIVERSITY",65,0,9,16,0,4,94,100,92,101,1,194,37,57,0,2021
"898",898,"OHIO NORTHERN UNIVERSITY",1,0,1,4,0,0,6,56,24,38,0,62,2,4,0,2021
"899",899,"OHIO STATE UNIVERSITY",19,1,6,8,0,9,43,132,82,91,2,175,21,21,1,2021
"900",900,"OKLAHOMA CITY UNIVERSITY",24,6,9,5,1,21,66,91,81,76,0,157,28,38,0,2021
"901",901,"OKLAHOMA, UNIVERSITY OF",19,6,7,11,0,19,62,144,99,106,1,206,26,35,1,2021
"902",902,"OREGON, UNIVERSITY OF",15,3,6,6,0,15,45,128,69,104,0,173,21,24,0,2021
"903",903,"PACE UNIVERSITY",40,0,13,12,0,17,82,182,93,171,0,264,23,59,0,2021
"904",904,"PENNSYLVANIA STATE - DICKINSON LAW",5,0,5,12,0,7,29,56,44,39,2,85,14,15,0,2021
"905",905,"PENNSYLVANIA STATE - PENN STATE LAW",15,0,6,11,0,9,41,91,56,76,0,132,18,23,0,2021
"906",906,"PENNSYLVANIA, UNIVERSITY OF",31,0,49,20,0,20,120,158,126,151,1,278,52,67,1,2021
"907",907,"PEPPERDINE UNIVERSITY",34,1,24,11,0,9,79,127,86,120,0,206,35,44,0,2021
"908",908,"PITTSBURGH, UNIVERSITY OF",14,0,10,9,0,7,40,112,69,83,0,152,19,21,0,2021
"909",909,"PONTIFICAL CATHOLIC UNIVERSITY OF P.R.",243,0,0,0,0,0,243,0,91,152,0,243,91,152,0,2021
"910",910,"PUERTO RICO, UNIVERSITY OF",82,0,0,0,0,34,116,0,35,81,0,116,35,81,0,2021
"911",911,"QUINNIPIAC UNIVERSITY",15,0,6,7,0,3,31,90,39,82,0,121,9,22,0,2021
"912",912,"REGENT UNIVERSITY",9,1,6,3,2,4,25,96,58,63,0,121,10,15,0,2021
"913",913,"RICHMOND, UNIVERSITY OF",14,0,8,6,0,10,38,99,46,91,0,137,14,24,0,2021
"914",914,"ROGER WILLIAMS UNIVERSITY",24,1,7,10,0,7,49,133,69,109,4,182,20,28,1,2021
"915",915,"RUTGERS UNIVERSITY",49,2,46,48,0,6,151,264,204,207,4,415,61,88,2,2021
"916",916,"SAINT LOUIS UNIVERSITY",14,2,11,21,0,1,49,159,94,114,0,208,17,32,0,2021
"917",917,"SAMFORD UNIVERSITY",7,0,4,25,0,3,39,122,66,95,0,161,11,28,0,2021
"918",918,"SAN DIEGO, UNIVERSITY OF",37,1,28,9,1,9,85,126,78,133,0,211,35,50,0,2021
"919",919,"SAN FRANCISCO, UNIVERSITY OF",31,0,32,11,0,7,81,62,56,85,2,143,30,50,1,2021
"920",920,"SANTA CLARA UNIVERSITY",57,0,40,8,0,14,119,92,94,117,0,211,51,68,0,2021
"921",921,"SEATTLE UNIVERSITY",33,2,20,12,0,13,80,146,84,142,0,226,25,55,0,2021
"922",922,"SETON HALL UNIVERSITY",22,0,34,12,0,25,93,232,144,181,0,325,31,62,0,2021
"923",923,"SOUTH CAROLINA, UNIVERSITY OF",16,1,1,20,0,3,41,163,96,107,1,204,14,27,0,2021
"924",924,"SOUTH DAKOTA, UNIVERSITY OF",4,2,0,1,0,5,12,65,31,46,0,77,3,9,0,2021
"925",925,"SOUTH TEXAS COLLEGE OF LAW HOUSTON",145,0,35,48,0,14,242,271,246,267,0,513,101,141,0,2021
"926",926,"SOUTHERN CALIFORNIA, UNIVERSITY OF",29,0,44,17,0,13,103,96,72,125,2,199,32,70,1,2021
"927",927,"SOUTHERN ILLINOIS UNIVERSITY-CARBONDALE",0,0,5,8,0,2,15,73,43,45,0,88,9,6,0,2021
"928",928,"SOUTHERN METHODIST UNIVERSITY",23,2,16,18,0,13,72,143,93,122,0,215,27,45,0,2021
"929",929,"SOUTHERN UNIVERSITY",14,0,8,221,0,4,247,85,136,194,2,332,93,154,0,2021
"930",930,"SOUTHWESTERN LAW SCHOOL",107,0,30,20,1,22,180,184,159,201,4,364,67,110,3,2021
"931",931,"ST. JOHN'S UNIVERSITY",38,0,22,33,1,7,101,164,125,140,0,265,45,56,0,2021
"932",932,"ST. MARY'S UNIVERSITY",148,5,7,9,0,0,169,122,126,165,0,291,77,92,0,2021
"933",933,"ST. THOMAS UNIVERSITY (FLORIDA)",184,1,10,29,0,1,225,76,144,157,0,301,102,123,0,2021
"934",934,"ST. THOMAS, UNIVERSITY OF (MINNESOTA)",11,0,9,9,0,5,34,122,61,94,1,156,13,21,0,2021
"935",935,"STANFORD UNIVERSITY",26,0,19,12,0,18,75,100,88,84,3,175,39,35,1,2021
"936",936,"STETSON UNIVERSITY",59,4,10,18,0,2,93,226,138,180,1,319,43,49,1,2021
"937",937,"SUFFOLK UNIVERSITY",59,0,26,15,0,9,109,324,143,287,3,433,31,77,1,2021
"938",938,"SYRACUSE UNIVERSITY",33,2,20,30,0,14,99,192,128,163,0,291,34,65,0,2021
"939",939,"TEMPLE UNIVERSITY",30,0,17,21,0,6,74,143,105,108,4,217,30,41,3,2021
"940",940,"TENNESSEE, UNIVERSITY OF",8,1,0,9,0,5,23,98,61,58,2,121,8,14,1,2021
"941",941,"TEXAS A&M UNIVERSITY",27,2,10,10,0,9,58,111,76,93,0,169,23,35,0,2021
"942",942,"TEXAS AT AUSTIN, UNIVERSITY OF",47,1,45,16,0,15,124,270,166,228,0,394,36,88,0,2021
"943",943,"TEXAS SOUTHERN UNIVERSITY THURGOOD MARSHALL SCHOOL OF LAW",69,3,11,102,1,0,186,21,84,123,0,207,71,115,0,2021
"944",944,"TEXAS TECH UNIVERSITY",20,4,4,9,0,22,59,96,69,86,0,155,29,30,0,2021
"945",945,"TOLEDO, UNIVERSITY OF",9,0,0,10,0,6,25,131,83,73,0,156,9,16,0,2021
"946",946,"TOURO UNIVERSITY",35,0,22,21,2,7,87,129,100,116,0,216,33,54,0,2021
"947",947,"TULANE UNIVERSITY",31,1,1,11,0,4,48,161,90,119,0,209,17,31,0,2021
"948",948,"TULSA, UNIVERSITY OF",12,3,6,7,1,2,31,91,61,61,0,122,15,16,0,2021
"949",949,"UNIVERSITY OF BUFFALO-SUNY",14,0,2,7,0,3,26,120,59,87,0,146,12,14,0,2021
"950",950,"UNIVERSITY OF CALIFORNIA COLLEGE OF THE LAW, SAN FRANCISCO",74,0,89,12,0,23,198,185,160,220,3,383,77,120,1,2021
"951",951,"UNIVERSITY OF ILLINOIS CHICAGO SCHOOL OF LAW",49,0,26,41,0,11,127,247,140,227,7,374,39,86,2,2021
"952",952,"UNIVERSITY OF MASSACHUSETTS DARTMOUTH",15,3,8,9,0,6,41,89,57,73,0,130,22,19,0,2021
"953",953,"UNIVERSITY OF NEVADA - LAS VEGAS",23,0,8,9,1,11,52,94,73,73,0,146,16,36,0,2021
"954",954,"UTAH, UNIVERSITY OF",11,0,4,1,0,1,17,75,40,52,0,92,4,13,0,2021
"955",955,"VANDERBILT UNIVERSITY",21,0,13,15,0,2,51,99,71,79,0,150,25,26,0,2021
"956",956,"VERMONT LAW SCHOOL",22,0,6,9,0,3,40,112,57,94,1,152,11,29,0,2021
"957",957,"VILLANOVA UNIVERSITY",15,0,14,10,0,11,50,165,88,127,0,215,22,28,0,2021
"958",958,"VIRGINIA, UNIVERSITY OF",16,0,46,22,0,13,97,195,140,151,1,292,41,56,0,2021
"959",959,"WAKE FOREST UNIVERSITY",13,2,14,12,0,6,47,119,76,90,0,166,14,33,0,2021
"960",960,"WASHBURN UNIVERSITY",12,1,0,4,0,2,19,73,43,49,0,92,5,14,0,2021
"961",961,"WASHINGTON AND LEE UNIVERSITY",11,0,6,7,0,4,28,110,63,75,0,138,11,17,0,2021
"962",962,"WASHINGTON UNIVERSITY",11,1,18,24,0,8,62,183,123,119,3,245,33,27,2,2021
"963",963,"WASHINGTON, UNIVERSITY OF",21,1,24,9,0,13,68,91,65,92,2,159,25,42,1,2021
"964",964,"WAYNE STATE UNIVERSITY",8,0,2,11,0,2,23,91,52,62,0,114,8,15,0,2021
"965",965,"WEST VIRGINIA UNIVERSITY",1,0,2,1,0,4,8,108,60,56,0,116,3,5,0,2021
"966",966,"COOLEY LAW SCHOOL",8,1,12,41,1,34,97,160,115,142,0,257,37,60,0,2021
"967",967,"WESTERN NEW ENGLAND UNIVERSITY",15,0,7,4,0,0,26,83,38,71,0,109,9,17,0,2021
"968",968,"WESTERN STATE COLLEGE OF LAW",30,1,13,6,2,8,60,47,45,62,0,107,25,35,0,2021
"969",969,"WIDENER UNIVERSITY-DELAWARE",30,2,14,33,1,6,86,173,120,139,0,259,33,53,0,2021
"970",970,"WIDENER-COMMONWEALTH",16,0,11,19,0,0,46,76,48,73,1,122,16,30,0,2021
"971",971,"WILLAMETTE UNIVERSITY",15,3,12,2,0,5,37,92,56,72,1,129,16,20,1,2021
"972",972,"WILLIAM AND MARY LAW SCHOOL",3,1,8,8,0,9,29,129,63,94,1,158,11,17,1,2021
"973",973,"WISCONSIN, UNIVERSITY OF",27,2,14,10,0,25,78,194,141,131,0,272,41,37,0,2021
"974",974,"WYOMING, UNIVERSITY OF",8,1,0,0,0,0,9,65,39,35,0,74,3,6,0,2021
"975",975,"YALE UNIVERSITY",32,1,34,15,0,22,104,90,93,100,1,194,42,62,0,2021
"976",976,"AKRON, UNIVERSITY OF",7,1,9,11,1,4,33,109,71,71,0,142,16,17,0,2022
"977",977,"ALABAMA, UNIVERSITY OF",13,0,3,14,0,9,39,107,75,71,0,146,19,20,0,2022
"978",978,"ALBANY LAW SCHOOL",15,0,11,15,0,5,46,146,82,108,1,192,15,31,0,2022
"979",979,"AMERICAN UNIVERSITY",54,0,33,28,0,21,136,238,127,247,0,374,35,101,0,2022
"980",980,"APPALACHIAN SCHOOL OF LAW",4,1,0,4,0,0,9,44,28,25,0,53,6,3,0,2022
"981",981,"ARIZONA STATE UNIVERSITY",36,5,25,10,2,20,98,178,118,154,0,276,36,61,0,2022
"982",982,"ARIZONA, UNIVERSITY OF",29,7,6,7,0,5,54,70,51,71,2,124,19,35,0,2022
"983",983,"ARKANSAS, FAYETTEVILLE, UNIVERSITY OF",13,2,0,11,0,9,35,87,59,63,0,122,14,21,0,2022
"984",984,"ARKANSAS, LITTLE ROCK, UNIVERSITY OF",12,2,5,13,0,0,32,113,67,78,0,145,11,21,0,2022
"985",985,"ATLANTA'S JOHN MARSHALL LAW SCHOOL",21,0,13,56,0,0,90,40,41,89,0,130,24,66,0,2022
"986",986,"AVE MARIA SCHOOL OF LAW",16,1,4,2,0,0,23,73,48,48,0,96,8,15,0,2022
"987",987,"BALTIMORE, UNIVERSITY OF",21,0,26,46,0,11,104,169,104,168,0,273,33,70,0,2022
"988",988,"BARRY UNIVERSITY",89,0,7,29,1,6,132,120,97,154,0,252,42,89,0,2022
"989",989,"BAYLOR UNIVERSITY",13,1,12,6,0,1,33,95,55,73,0,128,13,20,0,2022
"990",990,"BELMONT UNIVERSITY",15,0,1,0,0,7,23,93,44,72,0,116,8,15,0,2022
"991",991,"BOSTON COLLEGE",19,0,22,16,0,11,68,133,88,113,0,201,23,45,0,2022
"992",992,"BOSTON UNIVERSITY",35,1,22,11,0,16,85,118,104,99,0,203,32,53,0,2022
"993",993,"BRIGHAM YOUNG UNIVERSITY",5,3,8,0,2,0,18,96,61,53,0,114,9,9,0,2022
"994",994,"BROOKLYN LAW SCHOOL",56,0,45,20,0,10,131,227,146,208,3,358,43,88,0,2022
"995",995,"CALIFORNIA WESTERN SCHOOL OF LAW",70,0,15,6,0,9,100,104,81,122,1,204,42,57,1,2022
"996",996,"CALIFORNIA-BERKELEY, UNIVERSITY OF",36,0,56,15,0,22,129,123,90,156,6,252,31,94,4,2022
"997",997,"CALIFORNIA-DAVIS, UNIVERSITY OF",32,1,46,3,0,21,103,85,78,107,3,188,35,66,2,2022
"998",998,"CALIFORNIA-IRVINE, UNIVERSITY OF",31,0,36,9,0,11,87,67,67,83,1,154,33,52,0,2022
"999",999,"CALIFORNIA-LOS ANGELES, UNIVERSITY OF",71,3,31,15,0,20,140,148,118,167,3,288,53,86,1,2022
"1000",1000,"CAMPBELL UNIVERSITY",18,2,3,7,0,7,37,183,90,130,0,220,11,26,0,2022
"1001",1001,"CAPITAL UNIVERSITY",5,1,6,15,0,6,33,124,80,77,0,157,14,19,0,2022
"1002",1002,"CARDOZO SCHOOL OF LAW",36,0,34,12,0,4,86,184,105,165,0,270,29,57,0,2022
"1003",1003,"CASE WESTERN RESERVE UNIVERSITY",11,0,13,11,1,1,37,98,61,71,3,135,19,17,1,2022
"1004",1004,"CATHOLIC UNIVERSITY OF AMERICA",3,0,6,8,0,10,27,98,51,74,0,125,9,18,0,2022
"1005",1005,"CHAPMAN UNIVERSITY",27,0,21,9,1,8,66,67,58,75,0,133,30,36,0,2022
"1006",1006,"CHARLESTON SCHOOL OF LAW",17,2,3,8,0,0,30,160,67,123,0,190,12,18,0,2022
"1007",1007,"CHICAGO, UNIVERSITY OF",39,1,25,17,0,13,95,99,103,91,0,194,43,52,0,2022
"1008",1008,"CHICAGO-KENT COLLEGE OF LAW-IIT",38,0,16,17,0,5,76,149,98,124,3,225,31,45,0,2022
"1009",1009,"CINCINNATI, UNIVERSITY OF",8,0,5,5,6,3,27,99,44,71,0,126,6,10,0,2022
"1010",1010,"CITY UNIVERSITY OF NEW YORK",59,1,31,31,0,11,133,85,65,133,18,218,39,83,9,2022
"1011",1011,"CLEVELAND STATE UNIVERSITY",3,0,3,16,0,3,25,104,54,75,0,129,7,18,0,2022
"1012",1012,"COLORADO, UNIVERSITY OF",27,1,9,3,0,13,53,108,67,91,3,161,20,32,1,2022
"1013",1013,"COLUMBIA UNIVERSITY",40,1,55,46,0,6,148,177,157,165,0,325,73,74,0,2022
"1014",1014,"CONNECTICUT, UNIVERSITY OF",10,0,10,15,0,2,37,101,52,86,0,138,11,26,0,2022
"1015",1015,"CORNELL UNIVERSITY",26,0,27,18,0,4,75,83,91,67,0,158,42,33,0,2022
"1016",1016,"CREIGHTON UNIVERSITY",15,0,4,6,0,6,31,92,61,62,0,123,14,17,0,2022
"1017",1017,"DAYTON, UNIVERSITY OF",15,1,4,9,0,10,39,81,55,64,0,120,18,20,0,2022
"1018",1018,"DENVER, UNIVERSITY OF",35,3,22,5,1,17,83,191,100,167,1,274,29,54,0,2022
"1019",1019,"DEPAUL UNIVERSITY",24,0,16,16,0,9,65,123,64,122,0,188,14,50,0,2022
"1020",1020,"DETROIT MERCY, UNIVERSITY OF",9,0,4,14,0,1,28,86,40,74,0,114,5,23,0,2022
"1021",1021,"DISTRICT OF COLUMBIA",8,1,4,44,0,0,57,26,29,54,0,83,18,39,0,2022
"1022",1022,"DRAKE UNIVERSITY",3,0,6,4,0,4,17,94,47,64,0,111,7,10,0,2022
"1023",1023,"DREXEL UNIVERSITY",19,0,9,16,0,11,55,77,58,74,0,132,22,33,0,2022
"1024",1024,"DUKE UNIVERSITY",27,0,28,18,0,9,82,127,94,111,2,209,29,51,1,2022
"1025",1025,"DUQUESNE UNIVERSITY",11,0,3,7,0,5,26,138,83,80,0,164,12,14,0,2022
"1026",1026,"ELON UNIVERSITY",14,2,4,22,0,0,42,123,56,109,0,165,10,32,0,2022
"1027",1027,"EMORY UNIVERSITY",23,0,31,25,0,7,86,126,75,137,0,212,25,61,0,2022
"1028",1028,"FAULKNER UNIVERSITY",6,2,0,23,0,2,33,110,68,75,0,143,12,21,0,2022
"1029",1029,"FLORIDA A&M UNIVERSITY",35,1,2,50,0,3,91,37,43,85,0,128,25,66,0,2022
"1030",1030,"FLORIDA INTERNATIONAL UNIVERSITY",68,0,4,12,0,1,85,39,50,74,0,124,29,56,0,2022
"1031",1031,"FLORIDA STATE UNIVERSITY",4,0,4,7,0,21,36,75,56,55,0,111,16,20,0,2022
"1032",1032,"FLORIDA, UNIVERSITY OF",24,0,12,18,0,5,59,123,100,82,0,182,30,29,0,2022
"1033",1033,"FORDHAM UNIVERSITY",55,0,41,34,0,11,141,259,177,223,0,400,50,91,0,2022
"1034",1034,"GEORGE MASON UNIVERSITY",7,0,13,3,0,5,28,124,71,81,0,152,13,15,0,2022
"1035",1035,"GEORGE WASHINGTON UNIVERSITY",16,0,36,39,0,10,101,326,186,241,0,427,34,67,0,2022
"1036",1036,"GEORGETOWN UNIVERSITY",38,2,35,61,0,32,168,371,229,309,0,539,59,108,0,2022
"1037",1037,"GEORGIA STATE UNIVERSITY",21,1,10,32,0,5,69,123,78,114,0,192,23,46,0,2022
"1038",1038,"GEORGIA, UNIVERSITY OF",12,1,12,21,0,0,46,117,71,90,2,163,16,30,0,2022
"1039",1039,"GOLDEN GATE UNIVERSITY",0,0,5,9,0,9,23,17,14,26,0,40,7,16,0,2022
"1040",1040,"GONZAGA UNIVERSITY",37,0,7,0,0,10,54,144,89,107,2,198,22,31,1,2022
"1041",1041,"HARVARD UNIVERSITY",63,1,102,50,2,28,246,270,236,279,1,516,101,145,0,2022
"1042",1042,"HAWAII, UNIVERSITY OF",13,0,21,0,1,32,67,19,30,55,1,86,23,43,1,2022
"1043",1043,"HOFSTRA UNIVERSITY",34,1,23,18,0,7,83,172,134,121,0,255,36,47,0,2022
"1044",1044,"HOUSTON, UNIVERSITY OF",35,1,37,30,0,14,117,125,105,137,0,242,38,79,0,2022
"1045",1045,"HOWARD UNIVERSITY",2,0,0,128,0,28,158,1,67,92,0,159,67,91,0,2022
"1046",1046,"IDAHO, UNIVERSITY OF",8,1,2,5,4,22,42,100,76,65,0,142,21,20,0,2022
"1047",1047,"ILLINOIS, UNIVERSITY OF",12,0,17,9,0,5,43,79,66,56,0,122,18,25,0,2022
"1048",1048,"INDIANA UNIVERSITY - BLOOMINGTON",16,0,5,10,0,4,35,98,57,74,0,133,9,25,0,2022
"1049",1049,"INDIANA UNIVERSITY - INDIANAPOLIS",17,0,13,15,0,11,56,208,107,157,0,264,17,39,0,2022
"1050",1050,"INTER AMERICAN UNIVERSITY OF PUERTO RICO",370,0,0,2,0,0,372,2,138,235,1,374,138,233,1,2022
"1051",1051,"IOWA, UNIVERSITY OF",10,0,6,2,0,9,27,105,57,40,0,132,13,10,0,2022
"1052",1052,"KANSAS, UNIVERSITY OF",7,0,2,6,0,7,22,109,52,74,5,131,11,11,0,2022
"1053",1053,"KENTUCKY, UNIVERSITY OF",8,2,0,11,0,0,21,93,57,57,0,114,12,9,0,2022
"1054",1054,"LEWIS AND CLARK COLLEGE",24,1,16,3,0,1,45,95,49,91,0,140,13,32,0,2022
"1055",1055,"LIBERTY UNIVERSITY",10,0,0,7,0,5,22,97,62,57,0,119,11,11,0,2022
"1056",1056,"LINCOLN MEMORIAL",3,0,2,5,0,13,23,103,45,80,1,126,4,19,0,2022
"1057",1057,"LOUISIANA STATE UNIVERSITY",12,1,7,22,1,8,51,153,101,103,0,204,18,33,0,2022
"1058",1058,"LOUISVILLE, UNIVERSITY OF",9,0,4,9,0,4,26,96,47,75,0,122,6,20,0,2022
"1059",1059,"LOYOLA MARYMOUNT UNIVERSITY-LOS ANGELES",76,0,34,21,1,10,142,155,105,192,0,297,43,99,0,2022
"1060",1060,"LOYOLA UNIVERSITY-CHICAGO",31,0,21,23,0,18,93,173,86,180,0,266,27,66,0,2022
"1061",1061,"LOYOLA UNIVERSITY-NEW ORLEANS",21,0,4,27,0,8,60,144,90,114,0,204,19,41,0,2022
"1062",1062,"MAINE, UNIVERSITY OF",6,1,5,0,0,5,17,65,33,47,0,82,8,9,0,2022
"1063",1063,"MARQUETTE UNIVERSITY",13,0,7,9,0,7,36,147,91,92,0,183,20,16,0,2022
"1064",1064,"MARYLAND, UNIVERSITY OF",13,0,18,28,0,6,65,137,89,111,2,202,23,41,1,2022
"1065",1065,"MCGEORGE SCHOOL OF LAW",52,0,3,3,23,9,90,78,69,92,7,168,36,49,5,2022
"1066",1066,"MEMPHIS, UNIVERSITY OF",5,2,2,21,0,0,30,70,45,55,0,100,12,18,0,2022
"1067",1067,"MERCER UNIVERSITY",8,0,5,8,0,6,27,122,57,92,0,149,7,20,0,2022
"1068",1068,"MIAMI, UNIVERSITY OF",116,0,1,20,9,8,154,188,141,200,0,342,57,96,0,2022
"1069",1069,"MICHIGAN STATE UNIVERSITY",22,4,5,21,1,12,65,138,96,106,1,203,30,35,0,2022
"1070",1070,"MICHIGAN, UNIVERSITY OF",36,3,50,22,0,24,135,189,157,163,0,324,62,72,0,2022
"1071",1071,"MINNESOTA, UNIVERSITY OF",23,2,15,8,0,7,55,145,103,94,3,200,24,30,1,2022
"1072",1072,"MISSISSIPPI COLLEGE",6,0,3,10,0,10,29,83,57,55,0,112,14,15,0,2022
"1073",1073,"MISSISSIPPI, UNIVERSITY OF",16,0,0,21,0,8,45,131,97,79,0,176,20,25,0,2022
"1074",1074,"MISSOURI, UNIVERSITY OF",9,1,7,4,0,5,26,98,54,70,0,124,10,16,0,2022
"1075",1075,"MISSOURI-KANSAS CITY, UNIVERSITY OF",12,3,2,5,0,9,31,128,74,84,1,159,12,19,0,2022
"1076",1076,"MITCHELL | HAMLINE",41,12,22,29,1,0,105,232,113,219,5,337,40,64,1,2022
"1077",1077,"MONTANA, UNIVERSITY OF",3,7,1,2,0,5,18,70,38,50,0,88,6,12,0,2022
"1078",1078,"NEBRASKA, UNIVERSITY OF",18,2,2,3,1,3,29,112,82,59,0,141,16,13,0,2022
"1079",1079,"NEW ENGLAND LAW | BOSTON",20,0,18,14,0,46,98,231,116,206,6,329,25,71,1,2022
"1080",1080,"NEW HAMPSHIRE, UNIVERSITY OF",21,0,14,13,0,9,57,180,130,107,0,237,29,28,0,2022
"1081",1081,"NEW MEXICO, UNIVERSITY OF",41,3,1,4,0,3,52,43,44,51,0,95,19,33,0,2022
"1082",1082,"NEW YORK LAW SCHOOL",40,0,33,11,0,13,97,224,115,203,0,321,30,67,0,2022
"1083",1083,"NEW YORK UNIVERSITY",42,0,54,35,0,17,148,201,145,195,9,349,45,98,5,2022
"1084",1084,"NORTH CAROLINA CENTRAL UNIVERSITY",16,6,2,99,0,0,123,32,44,109,2,155,35,87,1,2022
"1085",1085,"NORTH CAROLINA, UNIVERSITY OF",22,0,18,19,1,12,72,111,93,90,0,183,31,41,0,2022
"1086",1086,"NORTH DAKOTA, UNIVERSITY OF",0,0,2,4,0,8,14,61,44,31,0,75,9,5,0,2022
"1087",1087,"NORTHEASTERN UNIVERSITY SCHOOL OF LAW",27,0,28,17,0,12,84,154,71,163,2,238,18,65,1,2022
"1088",1088,"NORTHERN ILLINOIS UNIVERSITY",9,1,3,15,0,9,37,82,48,70,1,119,14,23,0,2022
"1089",1089,"NORTHERN KENTUCKY UNIVERSITY",3,0,2,2,0,0,7,83,41,49,0,90,2,5,0,2022
"1090",1090,"NORTHWESTERN UNIVERSITY",23,0,29,27,0,16,95,111,106,99,1,206,39,55,1,2022
"1091",1091,"NOTRE DAME, UNIVERSITY OF",21,2,14,9,0,13,59,96,81,74,0,155,28,31,0,2022
"1092",1092,"NOVA SOUTHEASTERN UNIVERSITY",81,0,13,14,0,1,109,111,85,133,0,220,36,71,0,2022
"1093",1093,"OHIO NORTHERN UNIVERSITY",1,0,0,7,1,2,11,46,26,31,0,57,4,7,0,2022
"1094",1094,"OHIO STATE UNIVERSITY",10,0,12,10,0,5,37,116,75,78,0,153,14,23,0,2022
"1095",1095,"OKLAHOMA CITY UNIVERSITY",26,4,2,11,0,11,54,90,69,75,0,144,24,30,0,2022
"1096",1096,"OKLAHOMA, UNIVERSITY OF",16,5,7,7,0,13,48,124,76,96,0,172,19,29,0,2022
"1097",1097,"OREGON, UNIVERSITY OF",24,1,14,2,0,9,50,103,64,89,0,153,21,29,0,2022
"1098",1098,"PACE UNIVERSITY",53,0,13,13,0,6,85,162,100,147,0,247,36,49,0,2022
"1099",1099,"PENNSYLVANIA STATE - DICKINSON LAW",10,0,4,13,0,1,28,57,37,45,3,85,8,19,1,2022
"1100",1100,"PENNSYLVANIA STATE - PENN STATE LAW",20,0,12,9,0,3,44,94,59,78,1,138,17,27,0,2022
"1101",1101,"PENNSYLVANIA, UNIVERSITY OF",32,1,40,20,0,13,106,114,102,116,2,220,49,57,0,2022
"1102",1102,"PEPPERDINE UNIVERSITY",18,1,13,9,0,9,50,134,71,113,0,184,22,28,0,2022
"1103",1103,"PITTSBURGH, UNIVERSITY OF",11,0,4,7,0,7,29,91,66,54,0,120,10,19,0,2022
"1104",1104,"PONTIFICAL CATHOLIC UNIVERSITY OF P.R.",235,0,0,0,0,0,235,0,98,137,0,235,98,137,0,2022
"1105",1105,"PUERTO RICO, UNIVERSITY OF",134,0,0,0,0,0,134,0,51,83,0,134,51,83,0,2022
"1106",1106,"QUINNIPIAC UNIVERSITY",13,0,6,3,0,4,26,93,49,70,0,119,10,16,0,2022
"1107",1107,"REGENT UNIVERSITY",6,0,5,4,0,3,18,96,55,59,0,114,6,12,0,2022
"1108",1108,"RICHMOND, UNIVERSITY OF",14,0,8,4,0,4,30,88,46,72,0,118,10,20,0,2022
"1109",1109,"ROGER WILLIAMS UNIVERSITY",29,0,8,11,0,3,51,149,79,118,3,200,22,29,0,2022
"1110",1110,"RUTGERS UNIVERSITY",48,4,38,29,1,16,136,204,169,170,1,340,55,81,0,2022
"1111",1111,"SAINT LOUIS UNIVERSITY",15,0,9,17,0,11,52,130,76,106,0,182,19,33,0,2022
"1112",1112,"SAMFORD UNIVERSITY",9,0,3,12,0,2,26,115,64,77,0,141,8,18,0,2022
"1113",1113,"SAN DIEGO, UNIVERSITY OF",50,0,27,2,0,18,97,140,87,149,1,237,36,61,0,2022
"1114",1114,"SAN FRANCISCO, UNIVERSITY OF",31,0,17,11,0,14,73,52,51,71,3,125,29,41,3,2022
"1115",1115,"SANTA CLARA UNIVERSITY",47,0,42,7,1,15,112,87,94,105,0,199,48,64,0,2022
"1116",1116,"SEATTLE UNIVERSITY",35,0,24,11,0,14,84,130,89,125,0,214,38,46,0,2022
"1117",1117,"SETON HALL UNIVERSITY",33,1,16,17,0,8,75,139,103,111,0,214,29,46,0,2022
"1118",1118,"SOUTH CAROLINA, UNIVERSITY OF",13,0,3,21,0,4,41,152,88,105,0,193,20,21,0,2022
"1119",1119,"SOUTH DAKOTA, UNIVERSITY OF",3,4,1,3,0,0,11,72,51,32,0,83,5,6,0,2022
"1120",1120,"SOUTH TEXAS COLLEGE OF LAW HOUSTON",167,4,50,41,0,11,273,277,248,301,0,550,113,159,0,2022
"1121",1121,"SOUTHERN CALIFORNIA, UNIVERSITY OF",21,0,46,16,0,16,99,114,72,141,0,213,27,72,0,2022
"1122",1122,"SOUTHERN ILLINOIS UNIVERSITY-CARBONDALE",3,0,6,3,0,4,16,72,47,41,0,88,8,8,0,2022
"1123",1123,"SOUTHERN METHODIST UNIVERSITY",25,2,18,11,0,12,68,150,92,126,0,218,23,45,0,2022
"1124",1124,"SOUTHERN UNIVERSITY",24,1,3,189,0,2,219,90,116,192,1,309,67,151,1,2022
"1125",1125,"SOUTHWESTERN LAW SCHOOL",112,0,29,20,0,17,178,165,132,211,0,343,60,118,0,2022
"1126",1126,"ST. JOHN'S UNIVERSITY",26,0,21,25,1,11,84,152,105,131,0,236,38,46,0,2022
"1127",1127,"ST. MARY'S UNIVERSITY",141,0,10,9,0,0,160,138,130,168,0,298,67,93,0,2022
"1128",1128,"ST. THOMAS UNIVERSITY (FLORIDA)",171,0,5,11,0,6,193,43,110,126,0,236,86,107,0,2022
"1129",1129,"ST. THOMAS, UNIVERSITY OF (MINNESOTA)",12,1,7,7,0,5,32,115,52,95,0,147,12,20,0,2022
"1130",1130,"STANFORD UNIVERSITY",25,0,23,12,0,22,82,85,75,91,1,167,34,47,1,2022
"1131",1131,"STETSON UNIVERSITY",56,5,12,8,0,0,81,209,138,152,0,290,39,42,0,2022
"1132",1132,"SUFFOLK UNIVERSITY",53,0,17,25,0,10,105,309,149,265,0,414,35,70,0,2022
"1133",1133,"SYRACUSE UNIVERSITY",30,0,19,18,1,16,84,208,118,170,3,292,33,50,1,2022
"1134",1134,"TEMPLE UNIVERSITY",17,0,31,18,1,3,70,122,92,97,2,192,30,40,0,2022
"1135",1135,"TENNESSEE, UNIVERSITY OF",11,1,0,14,0,3,29,102,64,65,0,131,14,14,0,2022
"1136",1136,"TEXAS A&M UNIVERSITY",18,0,11,9,0,8,46,74,64,56,0,120,22,24,0,2022
"1137",1137,"TEXAS AT AUSTIN, UNIVERSITY OF",36,0,32,17,0,6,91,175,126,140,0,266,33,58,0,2022
"1138",1138,"TEXAS SOUTHERN UNIVERSITY THURGOOD MARSHALL SCHOOL OF LAW",68,0,9,110,0,9,196,14,82,128,0,210,74,122,0,2022
"1139",1139,"TEXAS TECH UNIVERSITY",34,2,7,8,0,8,59,90,58,91,0,149,22,37,0,2022
"1140",1140,"COOLEY LAW SCHOOL",11,2,9,37,1,39,99,148,110,137,0,247,33,66,0,2022
"1141",1141,"TOLEDO, UNIVERSITY OF",2,0,2,6,0,6,16,77,39,54,0,93,8,8,0,2022
"1142",1142,"TOURO UNIVERSITY",38,0,14,17,0,7,76,115,101,90,0,191,33,43,0,2022
"1143",1143,"TULANE UNIVERSITY",30,1,13,11,0,2,57,140,89,108,0,197,23,34,0,2022
"1144",1144,"TULSA, UNIVERSITY OF",11,9,4,7,0,0,31,97,66,62,0,128,14,17,0,2022
"1145",1145,"UNIVERSITY OF BUFFALO-SUNY",12,0,6,3,0,6,27,107,59,75,0,134,12,15,0,2022
"1146",1146,"UNIVERSITY OF CALIFORNIA COLLEGE OF THE LAW, SAN FRANCISCO",73,1,82,15,0,36,207,169,149,223,4,376,83,122,2,2022
"1147",1147,"UNIVERSITY OF ILLINOIS CHICAGO SCHOOL OF LAW",51,0,25,33,0,12,121,233,133,205,0,354,42,76,0,2022
"1148",1148,"UNIVERSITY OF MASSACHUSETTS DARTMOUTH",15,0,5,3,0,3,26,87,40,73,0,113,8,18,0,2022
"1149",1149,"UNIVERSITY OF NEVADA - LAS VEGAS",24,1,7,4,1,13,50,68,55,63,0,118,20,30,0,2022
"1150",1150,"UTAH, UNIVERSITY OF",6,1,3,0,0,5,15,80,44,50,1,95,7,8,0,2022
"1151",1151,"VANDERBILT UNIVERSITY",14,0,15,19,0,0,48,99,66,80,0,147,15,33,0,2022
"1152",1152,"VERMONT LAW SCHOOL",26,0,3,5,0,9,43,113,49,107,0,156,11,32,0,2022
"1153",1153,"VILLANOVA UNIVERSITY",22,1,8,12,0,4,47,130,71,106,0,177,18,29,0,2022
"1154",1154,"VIRGINIA, UNIVERSITY OF",22,0,45,25,0,12,104,194,150,146,2,298,48,56,0,2022
"1155",1155,"WAKE FOREST UNIVERSITY",10,0,5,13,0,3,31,123,73,80,1,154,15,16,0,2022
"1156",1156,"WASHBURN UNIVERSITY",12,2,3,7,0,4,28,55,49,34,0,83,15,13,0,2022
"1157",1157,"WASHINGTON AND LEE UNIVERSITY",9,0,11,9,1,0,30,70,53,47,0,100,10,20,0,2022
"1158",1158,"WASHINGTON UNIVERSITY",21,0,22,16,1,7,67,162,87,136,3,229,20,47,0,2022
"1159",1159,"WASHINGTON, UNIVERSITY OF",18,2,35,1,0,13,69,102,69,100,0,171,23,45,0,2022
"1160",1160,"WAYNE STATE UNIVERSITY",1,0,1,12,0,1,15,104,42,77,0,119,4,11,0,2022
"1161",1161,"WEST VIRGINIA UNIVERSITY",2,0,0,3,0,7,12,90,53,49,0,102,5,7,0,2022
"1162",1162,"WESTERN NEW ENGLAND UNIVERSITY",11,0,3,11,0,0,25,65,39,50,1,90,8,16,1,2022
"1163",1163,"WESTERN STATE COLLEGE OF LAW",49,2,20,5,2,0,78,51,59,69,1,129,34,44,0,2022
"1164",1164,"WIDENER UNIVERSITY-DELAWARE",21,0,7,30,0,7,65,166,105,126,0,231,25,40,0,2022
"1165",1165,"WIDENER-COMMONWEALTH",24,2,11,14,0,0,51,87,53,84,1,138,18,33,0,2022
"1166",1166,"WILLAMETTE UNIVERSITY",16,1,1,3,0,4,25,87,44,66,1,112,8,16,1,2022
"1167",1167,"WILLIAM AND MARY LAW SCHOOL",4,0,10,10,0,18,42,154,80,116,0,196,14,28,0,2022
"1168",1168,"WISCONSIN, UNIVERSITY OF",21,1,12,13,0,9,56,176,115,117,0,232,26,30,0,2022
"1169",1169,"WYOMING, UNIVERSITY OF",0,0,3,1,0,12,16,55,39,32,0,71,10,6,0,2022
"1170",1170,"YALE UNIVERSITY",29,4,29,22,0,13,97,84,86,95,0,181,44,53,0,2022
"1171",1171,"AKRON, UNIVERSITY OF",2,0,3,9,0,3,17,111,64,64,0,128,8,9,0,2023
"1172",1172,"ALABAMA, UNIVERSITY OF",3,0,5,15,0,2,25,97,60,61,1,122,8,17,0,2023
"1173",1173,"ALBANY LAW SCHOOL",23,1,11,9,0,2,46,125,78,89,1,171,16,30,0,2023
"1174",1174,"AMERICAN UNIVERSITY",65,0,50,26,0,17,158,228,152,234,0,386,51,107,0,2023
"1175",1175,"APPALACHIAN SCHOOL OF LAW",6,3,2,11,0,0,22,34,30,26,0,56,11,11,0,2023
"1176",1176,"ARIZONA STATE UNIVERSITY",26,9,9,5,0,10,59,124,86,96,1,183,29,30,0,2023
"1177",1177,"ARIZONA, UNIVERSITY OF",5,3,4,0,2,20,34,78,50,56,0,112,10,23,0,2023
"1178",1178,"ARKANSAS, FAYETTEVILLE, UNIVERSITY OF",17,1,2,4,0,8,32,95,50,77,0,127,10,22,0,2023
"1179",1179,"ARKANSAS, LITTLE ROCK, UNIVERSITY OF",7,2,3,13,0,5,30,91,45,75,0,121,12,17,0,2023
"1180",1180,"ATLANTA'S JOHN MARSHALL LAW SCHOOL",12,3,7,44,0,0,66,51,47,70,0,117,19,47,0,2023
"1181",1181,"AVE MARIA SCHOOL OF LAW",26,0,4,0,1,0,31,57,50,38,0,88,11,20,0,2023
"1182",1182,"BALTIMORE, UNIVERSITY OF",29,0,26,40,0,12,107,145,84,167,0,252,29,77,0,2023
"1183",1183,"BARRY UNIVERSITY",83,0,8,25,0,11,127,104,99,129,0,231,53,72,0,2023
"1184",1184,"BAYLOR UNIVERSITY",14,0,3,3,0,2,22,71,44,49,0,93,10,12,0,2023
"1185",1185,"BELMONT UNIVERSITY",8,1,1,2,0,5,17,90,37,68,1,107,2,15,0,2023
"1186",1186,"BOSTON COLLEGE",14,0,26,26,0,0,66,134,96,104,0,200,33,33,0,2023
"1187",1187,"BOSTON UNIVERSITY",37,0,33,9,0,15,94,127,96,125,0,221,25,69,0,2023
"1188",1188,"BRIGHAM YOUNG UNIVERSITY",7,1,5,2,0,2,17,79,55,41,0,96,7,10,0,2023
"1189",1189,"BROOKLYN LAW SCHOOL",51,0,50,20,0,9,130,225,118,230,6,355,42,84,3,2023
"1190",1190,"CALIFORNIA WESTERN SCHOOL OF LAW",55,1,19,5,1,13,94,104,77,119,2,198,33,60,1,2023
"1191",1191,"CALIFORNIA-BERKELEY, UNIVERSITY OF",36,3,76,20,0,29,164,140,101,191,11,304,47,113,4,2023
"1192",1192,"CALIFORNIA-DAVIS, UNIVERSITY OF",39,1,34,10,0,15,99,94,68,119,5,193,31,64,3,2023
"1193",1193,"CALIFORNIA-IRVINE, UNIVERSITY OF",22,0,40,4,0,8,74,66,65,67,4,140,36,33,3,2023
"1194",1194,"CALIFORNIA-LOS ANGELES, UNIVERSITY OF",52,2,46,28,0,22,150,150,109,189,2,300,53,96,1,2023
"1195",1195,"CAMPBELL UNIVERSITY",16,4,14,15,0,1,50,134,79,105,0,184,12,38,0,2023
"1196",1196,"CAPITAL UNIVERSITY",5,0,5,13,0,11,34,119,69,84,0,153,13,21,0,2023
"1197",1197,"CARDOZO SCHOOL OF LAW",37,1,34,12,0,11,95,170,98,162,3,265,27,65,1,2023
"1198",1198,"CASE WESTERN RESERVE UNIVERSITY",9,0,9,13,0,1,32,118,64,85,1,150,12,20,0,2023
"1199",1199,"CATHOLIC UNIVERSITY OF AMERICA",14,0,5,6,0,4,29,81,56,53,0,110,17,12,0,2023
"1200",1200,"CHAPMAN UNIVERSITY",27,0,16,7,0,7,57,54,47,64,0,111,25,32,0,2023
"1201",1201,"CHARLESTON SCHOOL OF LAW",14,2,1,0,0,12,29,185,56,158,0,214,7,22,0,2023
"1202",1202,"CHICAGO-KENT COLLEGE OF LAW-IIT",35,0,14,9,0,12,70,136,79,122,3,206,23,45,1,2023
"1203",1203,"CHICAGO, UNIVERSITY OF",23,0,24,15,0,25,87,88,88,87,0,175,45,42,0,2023
"1204",1204,"CINCINNATI, UNIVERSITY OF",9,2,8,11,0,0,30,85,48,62,0,115,10,18,0,2023
"1205",1205,"CITY UNIVERSITY OF NEW YORK",62,4,33,38,0,7,144,70,60,135,15,214,40,91,10,2023
"1206",1206,"CLEVELAND STATE UNIVERSITY",3,1,7,15,2,10,38,100,61,74,1,138,12,24,1,2023
"1207",1207,"COLORADO, UNIVERSITY OF",34,1,9,2,0,11,57,111,64,100,4,168,18,38,1,2023
"1208",1208,"COLUMBIA UNIVERSITY",46,1,57,48,0,0,152,178,148,174,0,330,62,87,0,2023
"1209",1209,"CONNECTICUT, UNIVERSITY OF",20,0,10,14,0,1,45,96,58,82,1,141,12,32,1,2023
"1210",1210,"COOLEY LAW SCHOOL",7,1,4,26,0,27,65,127,84,108,0,192,23,42,0,2023
"1211",1211,"CORNELL UNIVERSITY",25,2,22,7,0,3,59,90,77,72,0,149,30,29,0,2023
"1212",1212,"CREIGHTON UNIVERSITY",23,3,3,10,4,0,43,91,63,69,2,134,15,27,1,2023
"1213",1213,"DAYTON, UNIVERSITY OF",15,0,7,11,0,5,38,95,56,76,1,133,15,23,0,2023
"1214",1214,"DENVER, UNIVERSITY OF",29,0,8,4,0,10,51,206,85,133,0,257,18,27,0,2023
"1215",1215,"DEPAUL UNIVERSITY",18,0,10,11,0,1,40,115,51,101,3,155,7,31,2,2023
"1216",1216,"DETROIT MERCY, UNIVERSITY OF",9,0,0,7,0,2,18,31,15,34,0,49,5,13,0,2023
"1217",1217,"DISTRICT OF COLUMBIA",13,1,5,37,0,2,58,28,37,49,0,86,24,34,0,2023
"1218",1218,"DRAKE UNIVERSITY",4,0,2,3,0,2,11,104,46,69,0,115,4,7,0,2023
"1219",1219,"DREXEL UNIVERSITY",13,0,21,14,0,3,51,88,46,92,0,139,13,38,0,2023
"1220",1220,"DUKE UNIVERSITY",27,1,29,18,0,16,91,121,97,115,0,212,37,54,0,2023
"1221",1221,"DUQUESNE UNIVERSITY",13,0,7,7,0,4,31,136,78,89,0,167,12,19,0,2023
"1222",1222,"ELON UNIVERSITY",20,1,6,7,0,0,34,134,62,106,0,168,9,25,0,2023
"1223",1223,"EMORY UNIVERSITY",20,0,39,37,0,17,113,121,103,131,0,234,49,64,0,2023
"1224",1224,"FAULKNER UNIVERSITY",6,0,3,31,0,2,42,114,68,88,0,156,12,30,0,2023
"1225",1225,"FLORIDA A&M UNIVERSITY",31,0,4,41,0,10,86,35,43,78,0,121,24,62,0,2023
"1226",1226,"FLORIDA INTERNATIONAL UNIVERSITY",107,1,5,13,0,0,126,49,88,87,0,175,57,69,0,2023
"1227",1227,"FLORIDA STATE UNIVERSITY",24,0,8,9,0,8,49,86,63,72,0,135,20,29,0,2023
"1228",1228,"FLORIDA, UNIVERSITY OF",22,0,9,11,0,4,46,108,71,83,0,154,17,29,0,2023
"1229",1229,"FORDHAM UNIVERSITY",36,0,47,44,0,11,138,271,167,242,0,409,40,98,0,2023
"1230",1230,"GEORGE MASON UNIVERSITY",7,0,6,4,0,2,19,63,54,28,0,82,10,9,0,2023
"1231",1231,"GEORGE WASHINGTON UNIVERSITY",46,0,55,44,0,28,173,281,219,233,0,454,68,104,0,2023
"1232",1232,"GEORGETOWN UNIVERSITY",44,2,64,45,0,28,183,359,215,327,0,542,63,120,0,2023
"1233",1233,"GEORGIA STATE UNIVERSITY",29,1,16,34,0,5,85,127,82,130,0,212,28,57,0,2023
"1234",1234,"GEORGIA, UNIVERSITY OF",9,1,11,18,0,0,39,121,73,85,2,160,12,26,1,2023
"1235",1235,"GOLDEN GATE UNIVERSITY",0,0,3,1,1,8,13,9,5,17,0,22,2,11,0,2023
"1236",1236,"GONZAGA UNIVERSITY",25,2,12,1,0,14,54,137,94,93,2,191,23,28,1,2023
"1237",1237,"HARVARD UNIVERSITY",63,0,103,43,1,28,238,280,253,263,0,518,106,130,0,2023
"1238",1238,"HAWAII, UNIVERSITY OF",9,0,20,3,1,31,64,27,32,59,0,91,26,38,0,2023
"1239",1239,"HOFSTRA UNIVERSITY",29,2,18,22,0,3,74,184,120,138,0,258,26,48,0,2023
"1240",1240,"HOUSTON, UNIVERSITY OF",50,2,41,18,2,15,128,137,120,145,0,265,52,76,0,2023
"1241",1241,"HOWARD UNIVERSITY",0,0,0,151,0,30,181,0,81,99,1,181,81,99,1,2023
"1242",1242,"IDAHO, UNIVERSITY OF",16,4,2,6,1,21,50,108,78,80,0,158,24,26,0,2023
"1243",1243,"ILLINOIS, UNIVERSITY OF",15,0,13,9,0,4,41,88,64,63,2,129,20,21,0,2023
"1244",1244,"INDIANA UNIVERSITY - BLOOMINGTON",22,0,5,10,0,7,44,102,67,79,0,146,14,30,0,2023
"1245",1245,"INDIANA UNIVERSITY - INDIANAPOLIS",34,0,8,18,0,4,64,224,128,160,0,288,24,40,0,2023
"1246",1246,"INTER AMERICAN UNIVERSITY OF PUERTO RICO",153,0,0,1,0,0,154,0,49,104,0,154,49,104,0,2023
"1247",1247,"IOWA, UNIVERSITY OF",10,1,4,1,0,9,25,116,77,61,0,141,12,12,0,2023
"1248",1248,"KANSAS, UNIVERSITY OF",17,0,6,4,0,4,31,83,59,54,1,114,17,14,0,2023
"1249",1249,"KENTUCKY, UNIVERSITY OF",11,0,4,9,0,0,24,128,89,63,0,152,11,13,0,2023
"1250",1250,"LEWIS AND CLARK COLLEGE",17,0,9,3,0,0,29,122,65,86,0,151,16,13,0,2023
"1251",1251,"LIBERTY UNIVERSITY",10,0,4,5,0,6,25,79,63,41,0,104,10,15,0,2023
"1252",1252,"LINCOLN MEMORIAL",5,0,3,9,0,12,29,112,51,90,0,141,10,19,0,2023
"1253",1253,"LOUISIANA STATE UNIVERSITY",18,1,6,15,0,5,45,159,97,107,0,204,15,30,0,2023
"1254",1254,"LOUISVILLE, UNIVERSITY OF",16,1,2,2,0,3,24,93,52,65,0,117,7,17,0,2023
"1255",1255,"LOYOLA MARYMOUNT UNIVERSITY-LOS ANGELES",74,0,44,16,2,13,149,164,120,193,0,313,45,104,0,2023
"1256",1256,"LOYOLA UNIVERSITY-CHICAGO",33,1,37,16,0,12,99,175,98,176,0,274,39,60,0,2023
"1257",1257,"LOYOLA UNIVERSITY-NEW ORLEANS",31,1,4,26,0,11,73,132,79,123,3,205,25,46,2,2023
"1258",1258,"MAINE, UNIVERSITY OF",6,0,3,1,0,4,14,71,37,47,1,85,5,8,1,2023
"1259",1259,"MARQUETTE UNIVERSITY",24,0,5,7,0,8,44,151,97,98,0,195,20,24,0,2023
"1260",1260,"MARYLAND, UNIVERSITY OF",13,0,18,37,1,11,80,135,88,123,2,215,26,54,0,2023
"1261",1261,"MCGEORGE SCHOOL OF LAW",48,2,29,12,0,19,110,84,73,112,0,194,32,71,0,2023
"1262",1262,"MEMPHIS, UNIVERSITY OF",6,1,6,8,0,0,21,54,35,40,0,75,5,16,0,2023
"1263",1263,"MERCER UNIVERSITY",12,0,5,14,0,5,36,114,70,80,0,150,14,22,0,2023
"1264",1264,"MIAMI, UNIVERSITY OF",142,0,18,12,0,15,187,152,146,193,0,339,74,113,0,2023
"1265",1265,"MICHIGAN STATE UNIVERSITY",33,2,7,23,0,8,73,120,91,100,2,193,32,41,0,2023
"1266",1266,"MICHIGAN, UNIVERSITY OF",33,2,44,18,0,15,112,182,142,147,0,294,46,65,0,2023
"1267",1267,"MINNESOTA, UNIVERSITY OF",27,0,12,10,0,8,57,149,79,121,5,206,24,32,1,2023
"1268",1268,"MISSISSIPPI COLLEGE",1,0,1,19,0,8,29,74,47,56,0,103,13,16,0,2023
"1269",1269,"MISSISSIPPI, UNIVERSITY OF",6,0,5,23,0,6,40,126,81,85,0,166,12,28,0,2023
"1270",1270,"MISSOURI, UNIVERSITY OF",8,0,2,6,0,5,21,100,59,62,0,121,9,12,0,2023
"1271",1271,"MISSOURI-KANSAS CITY, UNIVERSITY OF",6,1,3,7,0,8,25,112,66,71,0,137,9,16,0,2023
"1272",1272,"MITCHELL | HAMLINE",38,15,13,40,0,9,115,218,113,198,7,333,33,75,2,2023
"1273",1273,"MONTANA, UNIVERSITY OF",9,3,2,3,0,2,19,67,37,49,0,86,7,12,0,2023
"1274",1274,"NEBRASKA, UNIVERSITY OF",17,2,1,4,1,1,26,119,80,65,0,145,14,12,0,2023
"1275",1275,"NEW ENGLAND LAW | BOSTON",22,0,22,16,0,58,118,236,113,237,1,354,33,84,1,2023
"1276",1276,"NEW HAMPSHIRE, UNIVERSITY OF",26,0,23,13,0,8,70,198,134,134,0,268,33,37,0,2023
"1277",1277,"NEW MEXICO, UNIVERSITY OF",38,3,3,4,0,5,53,35,39,48,0,88,26,27,0,2023
"1278",1278,"NEW YORK LAW SCHOOL",45,0,30,17,0,12,104,214,110,204,0,318,32,70,0,2023
"1279",1279,"NEW YORK UNIVERSITY",47,1,64,32,0,27,171,213,148,224,11,384,52,109,9,2023
"1280",1280,"NORTH CAROLINA CENTRAL UNIVERSITY",13,5,3,72,0,0,93,34,45,75,7,127,26,63,4,2023
"1281",1281,"NORTH CAROLINA, UNIVERSITY OF",21,0,18,13,0,6,58,120,70,107,0,178,16,42,0,2023
"1282",1282,"NORTH DAKOTA, UNIVERSITY OF",3,0,1,2,1,7,14,53,35,32,0,67,6,8,0,2023
"1283",1283,"NORTHEASTERN UNIVERSITY SCHOOL OF LAW",20,0,32,11,0,19,82,162,82,158,0,244,24,57,0,2023
"1284",1284,"NORTHERN ILLINOIS UNIVERSITY",9,0,12,11,0,11,43,67,47,63,0,110,21,22,0,2023
"1285",1285,"NORTHERN KENTUCKY UNIVERSITY",8,2,2,8,0,0,20,105,53,72,0,125,7,13,0,2023
"1286",1286,"NORTHWESTERN UNIVERSITY",30,0,28,25,0,16,99,111,90,116,0,210,41,56,0,2023
"1287",1287,"NOTRE DAME, UNIVERSITY OF",30,0,10,9,1,11,61,105,81,85,0,166,24,37,0,2023
"1288",1288,"NOVA SOUTHEASTERN UNIVERSITY",83,0,8,17,0,5,113,88,76,108,14,201,48,60,4,2023
"1289",1289,"OHIO NORTHERN UNIVERSITY",4,1,3,9,0,6,23,52,38,37,0,75,11,12,0,2023
"1290",1290,"OKLAHOMA CITY UNIVERSITY",22,5,2,10,0,18,57,86,67,76,0,143,23,34,0,2023
"1291",1291,"OKLAHOMA, UNIVERSITY OF",15,5,2,4,0,20,46,117,61,102,0,163,20,26,0,2023
"1292",1292,"OREGON, UNIVERSITY OF",28,0,14,2,0,7,51,100,83,62,0,151,24,25,0,2023
"1293",1293,"PACE UNIVERSITY",24,0,16,15,0,21,76,185,95,166,0,261,27,49,0,2023
"1294",1294,"PENNSYLVANIA STATE - DICKINSON LAW",13,1,11,9,0,5,39,55,42,49,3,94,11,27,1,2023
"1295",1295,"PENNSYLVANIA STATE - PENN STATE LAW",13,0,8,9,0,1,31,90,48,71,2,121,11,20,0,2023
"1296",1296,"PENNSYLVANIA, UNIVERSITY OF",32,0,31,21,0,21,105,119,102,116,4,224,44,59,1,2023
"1297",1297,"PEPPERDINE UNIVERSITY",17,0,13,5,0,10,45,123,64,104,0,168,17,28,0,2023
"1298",1298,"PITTSBURGH, UNIVERSITY OF",8,0,10,6,0,7,31,85,58,57,0,116,11,19,0,2023
"1299",1299,"PONTIFICAL CATHOLIC UNIVERSITY OF P.R.",162,0,0,0,0,0,162,0,57,105,0,162,57,105,0,2023
"1300",1300,"PUERTO RICO, UNIVERSITY OF",107,0,0,0,0,10,117,0,47,70,0,117,47,70,0,2023
"1301",1301,"QUINNIPIAC UNIVERSITY",19,0,5,5,0,3,32,73,41,64,0,105,8,24,0,2023
"1302",1302,"REGENT UNIVERSITY",8,1,5,4,1,0,19,95,49,65,0,114,7,12,0,2023
"1303",1303,"RICHMOND, UNIVERSITY OF",12,0,9,5,0,8,34,86,44,76,0,120,11,23,0,2023
"1304",1304,"ROGER WILLIAMS UNIVERSITY",24,0,4,12,0,6,46,112,51,106,0,158,13,33,0,2023
"1305",1305,"RUTGERS UNIVERSITY",39,0,39,40,0,11,129,247,151,222,0,376,38,91,0,2023
"1306",1306,"SAINT LOUIS UNIVERSITY",15,0,6,15,0,13,49,128,63,114,0,177,13,36,0,2023
"1307",1307,"SAMFORD UNIVERSITY",10,0,1,23,0,3,37,109,59,86,0,146,12,24,0,2023
"1308",1308,"SAN DIEGO, UNIVERSITY OF",60,0,35,3,0,19,117,128,74,169,2,245,40,77,0,2023
"1309",1309,"SAN FRANCISCO, UNIVERSITY OF",45,3,32,12,0,3,95,57,63,88,1,152,34,61,0,2023
"1310",1310,"SANTA CLARA UNIVERSITY",59,0,60,7,2,11,139,116,103,152,0,255,52,87,0,2023
"1311",1311,"SEATTLE UNIVERSITY",34,2,34,8,0,19,97,107,63,130,0,204,25,70,0,2023
"1312",1312,"SETON HALL UNIVERSITY",39,0,27,10,0,7,83,147,117,113,0,230,35,48,0,2023
"1313",1313,"SOUTH CAROLINA, UNIVERSITY OF",13,1,3,14,0,5,36,162,96,101,1,198,17,19,0,2023
"1314",1314,"SOUTH DAKOTA, UNIVERSITY OF",3,0,0,5,0,2,10,74,44,40,0,84,5,5,0,2023
"1315",1315,"SOUTH TEXAS COLLEGE OF LAW HOUSTON",170,3,48,43,0,4,268,283,221,327,0,551,105,162,0,2023
"1316",1316,"SOUTHERN CALIFORNIA, UNIVERSITY OF",28,0,36,16,0,13,93,69,69,93,0,162,37,56,0,2023
"1317",1317,"SOUTHERN ILLINOIS UNIVERSITY-CARBONDALE",3,1,0,13,0,17,34,74,58,49,0,108,15,19,0,2023
"1318",1318,"SOUTHERN METHODIST UNIVERSITY",25,0,12,11,0,6,54,130,82,102,0,184,24,30,0,2023
"1319",1319,"SOUTHERN UNIVERSITY",17,0,2,155,0,0,174,84,98,131,0,258,49,103,0,2023
"1320",1320,"SOUTHWESTERN LAW SCHOOL",106,1,40,13,0,21,181,157,131,203,3,338,60,118,2,2023
"1321",1321,"ST. THOMAS, UNIVERSITY OF (MINNESOTA)",13,0,6,7,0,4,30,121,65,85,0,151,11,19,0,2023
"1322",1322,"ST. JOHN'S UNIVERSITY",53,0,30,17,0,11,111,149,127,132,0,260,42,69,0,2023
"1323",1323,"ST. MARY'S UNIVERSITY",156,3,8,12,1,0,180,112,119,172,1,292,67,112,1,2023
"1324",1324,"ST. THOMAS UNIVERSITY (FLORIDA)",181,1,6,14,1,2,205,47,91,161,0,252,71,134,0,2023
"1325",1325,"STANFORD UNIVERSITY",26,2,35,12,0,16,91,63,62,90,2,154,34,56,1,2023
"1326",1326,"STETSON UNIVERSITY",44,1,11,14,0,0,70,225,113,181,0,295,26,44,0,2023
"1327",1327,"SUFFOLK UNIVERSITY",44,0,29,22,0,16,111,258,140,224,3,369,26,84,1,2023
"1328",1328,"SYRACUSE UNIVERSITY",27,1,18,28,2,11,87,213,122,178,0,300,30,57,0,2023
"1329",1329,"TEMPLE UNIVERSITY",21,0,31,22,0,4,78,123,100,95,4,201,31,44,2,2023
"1330",1330,"TENNESSEE, UNIVERSITY OF",14,0,3,9,0,6,32,101,64,69,0,133,16,16,0,2023
"1331",1331,"TEXAS A&M UNIVERSITY",21,0,8,4,0,11,44,88,61,70,0,132,19,25,0,2023
"1332",1332,"TEXAS AT AUSTIN, UNIVERSITY OF",27,0,24,17,0,7,75,166,123,118,0,241,27,48,0,2023
"1333",1333,"TEXAS SOUTHERN UNIVERSITY THURGOOD MARSHALL SCHOOL OF LAW",65,3,10,97,0,0,175,26,72,129,0,201,62,113,0,2023
"1334",1334,"TEXAS TECH UNIVERSITY",37,1,7,9,0,3,57,95,72,80,0,152,21,36,0,2023
"1335",1335,"OHIO STATE UNIVERSITY",11,0,13,10,0,7,41,114,70,84,0,155,15,26,0,2023
"1336",1336,"TOURO UNIVERSITY",35,1,15,15,0,5,71,104,87,88,0,175,34,37,0,2023
"1337",1337,"TULANE UNIVERSITY",25,0,7,17,0,1,50,131,74,98,0,181,21,24,0,2023
"1338",1338,"TULSA, UNIVERSITY OF",6,4,2,2,0,1,15,62,38,39,0,77,8,7,0,2023
"1339",1339,"UNIVERSITY OF BUFFALO-SUNY",9,0,6,9,0,2,26,103,55,71,3,129,9,15,2,2023
"1340",1340,"UNIVERSITY OF CALIFORNIA COLLEGE OF THE LAW, SAN FRANCISCO",86,0,78,4,0,24,192,162,142,209,3,354,72,118,2,2023
"1341",1341,"UNIVERSITY OF ILLINOIS CHICAGO SCHOOL OF LAW",51,1,26,38,0,9,125,239,132,216,0,364,40,81,0,2023
"1342",1342,"UNIVERSITY OF MASSACHUSETTS DARTMOUTH",13,0,3,8,0,5,29,78,40,67,0,107,10,19,0,2023
"1343",1343,"UNIVERSITY OF NEVADA - LAS VEGAS",22,1,13,11,0,10,57,68,56,64,3,125,17,36,2,2023
"1344",1344,"TOLEDO, UNIVERSITY OF",0,0,5,6,0,11,22,86,49,58,1,108,9,13,0,2023
"1345",1345,"UTAH, UNIVERSITY OF",10,1,1,0,0,0,12,82,40,51,2,94,3,8,0,2023
"1346",1346,"VANDERBILT UNIVERSITY",17,0,16,18,0,10,61,101,68,93,0,162,22,39,0,2023
"1347",1347,"VERMONT LAW SCHOOL",32,0,7,13,0,8,60,130,59,124,6,190,17,39,3,2023
"1348",1348,"VILLANOVA UNIVERSITY",11,0,16,10,0,4,41,113,70,82,0,154,14,27,0,2023
"1349",1349,"VIRGINIA, UNIVERSITY OF",30,0,34,32,0,14,110,184,138,155,1,294,48,62,0,2023
"1350",1350,"WAKE FOREST UNIVERSITY",8,1,9,6,1,7,32,135,71,96,0,167,15,17,0,2023
"1351",1351,"WASHBURN UNIVERSITY",9,1,3,6,0,4,23,76,55,44,0,99,12,11,0,2023
"1352",1352,"WASHINGTON AND LEE UNIVERSITY",12,0,13,13,1,0,39,53,42,49,0,92,9,30,0,2023
"1353",1353,"WASHINGTON UNIVERSITY",18,0,21,21,0,9,69,134,102,96,4,203,32,36,0,2023
"1354",1354,"WASHINGTON, UNIVERSITY OF",21,2,32,4,0,9,68,98,62,101,1,166,24,43,0,2023
"1355",1355,"WAYNE STATE UNIVERSITY",0,1,3,10,0,4,18,100,53,63,0,118,6,12,0,2023
"1356",1356,"WEST VIRGINIA UNIVERSITY",5,1,2,4,0,5,17,87,56,48,0,104,5,12,0,2023
"1357",1357,"WESTERN NEW ENGLAND UNIVERSITY",16,0,7,7,0,0,30,50,31,49,0,80,11,19,0,2023
"1358",1358,"WESTERN STATE COLLEGE OF LAW",42,0,19,5,1,1,68,52,69,50,0,120,37,30,0,2023
"1359",1359,"WIDENER-COMMONWEALTH",17,2,6,15,0,0,40,100,61,76,2,140,15,24,0,2023
"1360",1360,"WIDENER UNIVERSITY-DELAWARE",25,0,13,28,0,5,71,160,115,116,0,231,30,41,0,2023
"1361",1361,"WILLAMETTE UNIVERSITY",16,0,17,3,0,8,44,70,51,61,1,114,16,26,1,2023
"1362",1362,"WILLIAM AND MARY LAW SCHOOL",3,1,8,15,0,4,31,109,61,79,0,140,10,21,0,2023
"1363",1363,"WISCONSIN, UNIVERSITY OF",20,1,4,10,0,9,44,122,74,92,0,166,22,22,0,2023
"1364",1364,"WYOMING, UNIVERSITY OF",2,0,1,1,0,8,12,63,34,38,0,75,2,10,0,2023
"1365",1365,"YALE UNIVERSITY",33,1,34,23,0,12,103,84,87,97,3,187,46,57,0,2023
