"","School List","FT Male","FT Female","FT AGI","FT BIPOC","FT Total","FT White","Year","State"
"1","AKRON, UNIVERSITY OF",46,26,0,8,72,64,2017,"OHIO"
"2","ALABAMA, UNIVERSITY OF",74,29,0,11,103,92,2017,"ALABAMA"
"3","ALBANY LAW SCHOOL",49,35,0,8,84,76,2017,"NEW YORK"
"4","AMERICAN UNIVERSITY",225,165,0,74,390,316,2017,"DISTRICT OF COLUMBIA"
"5","APPALACHIAN SCHOOL OF LAW",13,7,0,1,20,19,2017,"VIRGINIA"
"6","ARIZONA STATE UNIVERSITY",125,59,0,25,184,159,2017,"ARIZONA"
"7","ARIZONA, UNIVERSITY OF",93,74,0,23,167,144,2017,"ARIZONA"
"8","ARKANSAS, FAYETTEVILLE, UNIVERSITY OF",45,40,0,12,85,73,2017,"ARKANSAS"
"9","ARKANSAS, LITTLE ROCK, UNIVERSITY OF",53,46,0,17,99,82,2017,"ARKANSAS"
"10","ATLANTA'S JOHN MARSHALL LAW SCHOOL",44,47,0,22,91,69,2017,"GEORGIA"
"11","AVE MARIA SCHOOL OF LAW",31,15,0,3,46,43,2017,"FLORIDA"
"12","BALTIMORE, UNIVERSITY OF",88,72,0,24,160,136,2017,"MARYLAND"
"13","BARRY UNIVERSITY",52,34,0,23,86,63,2017,"FLORIDA"
"14","BAYLOR UNIVERSITY",61,21,0,6,82,76,2017,"TEXAS"
"15","BELMONT UNIVERSITY",27,16,0,7,43,36,2017,"TENNESSEE"
"16","BOSTON COLLEGE",81,57,0,23,138,115,2017,"MASSACHUSETTS"
"17","BOSTON UNIVERSITY",164,84,0,23,248,225,2017,"MASSACHUSETTS"
"18","BRIGHAM YOUNG UNIVERSITY",75,27,0,6,102,96,2017,"UTAH"
"19","BROOKLYN LAW SCHOOL",141,93,0,29,234,205,2017,"NEW YORK"
"20","CALIFORNIA WESTERN SCHOOL OF LAW",68,53,0,19,121,102,2017,"CALIFORNIA"
"21","CALIFORNIA-BERKELEY, UNIVERSITY OF",177,129,0,60,306,246,2017,"CALIFORNIA"
"22","CALIFORNIA-DAVIS, UNIVERSITY OF",64,47,0,39,111,72,2017,"CALIFORNIA"
"23","CALIFORNIA-IRVINE, UNIVERSITY OF",67,50,0,27,117,90,2017,"CALIFORNIA"
"24","CALIFORNIA-LOS ANGELES, UNIVERSITY OF",115,89,0,42,204,162,2017,"CALIFORNIA"
"25","CAMPBELL UNIVERSITY",52,32,0,10,84,74,2017,"NORTH CAROLINA"
"26","CAPITAL UNIVERSITY",55,22,0,7,77,70,2017,"OHIO"
"27","CARDOZO SCHOOL OF LAW",134,92,0,19,226,207,2017,"NEW YORK"
"28","CASE WESTERN RESERVE UNIVERSITY",68,28,0,5,96,91,2017,"OHIO"
"29","CATHOLIC UNIVERSITY OF AMERICA",75,36,0,15,111,96,2017,"DISTRICT OF COLUMBIA"
"30","CHAPMAN UNIVERSITY",82,36,0,10,118,108,2017,"CALIFORNIA"
"31","CHARLESTON SCHOOL OF LAW",40,36,0,5,76,71,2017,"SOUTH CAROLINA"
"32","CHICAGO, UNIVERSITY OF",147,60,0,29,207,178,2017,"ILLINOIS"
"33","CHICAGO-KENT COLLEGE OF LAW-IIT",112,55,0,20,167,147,2017,"ILLINOIS"
"34","CINCINNATI, UNIVERSITY OF",46,29,0,9,75,66,2017,"OHIO"
"35","CITY UNIVERSITY OF NEW YORK",21,42,0,23,63,40,2017,"NEW YORK"
"36","CLEVELAND STATE UNIVERSITY",89,43,0,17,132,115,2017,"OHIO"
"37","COLORADO, UNIVERSITY OF",100,68,0,23,168,145,2017,"COLORADO"
"38","COLUMBIA UNIVERSITY",284,142,0,59,426,367,2017,"NEW YORK"
"39","CONNECTICUT, UNIVERSITY OF",109,49,0,11,159,148,2017,"CONNECTICUT"
"40","CORNELL UNIVERSITY",98,52,2,19,152,133,2017,"NEW YORK"
"41","CREIGHTON UNIVERSITY",49,16,0,7,65,58,2017,"NEBRASKA"
"42","DAYTON, UNIVERSITY OF",63,39,0,12,102,90,2017,"OHIO"
"43","DENVER, UNIVERSITY OF",218,135,0,36,354,318,2017,"COLORADO"
"44","DEPAUL UNIVERSITY",88,55,0,27,143,116,2017,"ILLINOIS"
"45","DETROIT MERCY, UNIVERSITY OF",53,38,0,13,91,78,2017,"MICHIGAN"
"46","DISTRICT OF COLUMBIA",29,33,0,28,62,34,2017,"DISTRICT OF COLUMBIA"
"47","DRAKE UNIVERSITY",37,30,0,5,67,62,2017,"IOWA"
"48","DREXEL UNIVERSITY",56,61,0,17,117,100,2017,"PENNSYLVANIA"
"49","DUKE UNIVERSITY",122,69,0,17,191,174,2017,"NORTH CAROLINA"
"50","DUQUESNE UNIVERSITY",62,36,0,7,98,91,2017,"PENNSYLVANIA"
"51","ELON UNIVERSITY",48,32,0,12,80,68,2017,"NORTH CAROLINA"
"52","EMORY UNIVERSITY",117,76,13,27,206,179,2017,"GEORGIA"
"53","FAULKNER UNIVERSITY",31,20,0,7,51,44,2017,"ALABAMA"
"54","FLORIDA A&M UNIVERSITY",30,34,0,43,64,21,2017,"FLORIDA"
"55","FLORIDA INTERNATIONAL UNIVERSITY",56,32,0,40,88,48,2017,"FLORIDA"
"56","FLORIDA STATE UNIVERSITY",88,55,0,23,143,120,2017,"FLORIDA"
"57","FLORIDA, UNIVERSITY OF",115,90,0,42,205,163,2017,"FLORIDA"
"58","FORDHAM UNIVERSITY",266,195,0,64,461,397,2017,"NEW YORK"
"59","GEORGE MASON UNIVERSITY",151,50,0,26,201,175,2017,"VIRGINIA"
"60","GEORGE WASHINGTON UNIVERSITY",564,309,0,106,873,767,2017,"DISTRICT OF COLUMBIA"
"61","GEORGETOWN UNIVERSITY",377,178,0,32,555,523,2017,"DISTRICT OF COLUMBIA"
"62","GEORGIA STATE UNIVERSITY",76,55,0,19,131,112,2017,"GEORGIA"
"63","GEORGIA, UNIVERSITY OF",67,36,0,14,103,89,2017,"GEORGIA"
"64","GOLDEN GATE UNIVERSITY",56,64,0,24,120,96,2017,"CALIFORNIA"
"65","GONZAGA UNIVERSITY",67,50,0,8,117,109,2017,"WASHINGTON"
"66","HARVARD UNIVERSITY",206,112,0,57,318,261,2017,"MASSACHUSETTS"
"67","HAWAII, UNIVERSITY OF",69,47,0,51,116,65,2017,"HAWAII"
"68","HOFSTRA UNIVERSITY",75,37,0,10,112,102,2017,"NEW YORK"
"69","HOUSTON, UNIVERSITY OF",143,82,0,38,225,187,2017,"TEXAS"
"70","HOWARD UNIVERSITY",39,37,0,62,76,14,2017,"DISTRICT OF COLUMBIA"
"71","IDAHO, UNIVERSITY OF",43,29,0,9,72,63,2017,"IDAHO"
"72","ILLINOIS, UNIVERSITY OF",77,49,0,21,126,105,2017,"ILLINOIS"
"73","INDIANA UNIVERSITY - BLOOMINGTON",74,43,0,14,117,103,2017,"INDIANA"
"74","INDIANA UNIVERSITY - INDIANAPOLIS",79,54,0,15,133,118,2017,"INDIANA"
"75","INTER AMERICAN UNIVERSITY OF PUERTO RICO",65,30,0,91,95,4,2017,"PUERTO RICO"
"76","IOWA, UNIVERSITY OF",49,29,0,7,78,71,2017,"IOWA"
"77","KANSAS, UNIVERSITY OF",48,32,0,9,80,71,2017,"KANSAS"
"78","KENTUCKY, UNIVERSITY OF",46,33,0,7,79,72,2017,"KENTUCKY"
"79","LEWIS AND CLARK COLLEGE",118,65,0,25,183,158,2017,"OREGON"
"80","LIBERTY UNIVERSITY",31,10,0,9,41,32,2017,"VIRGINIA"
"81","LINCOLN MEMORIAL",14,7,0,3,21,18,2017,"DISTRICT OF COLUMBIA"
"82","LOUISIANA STATE UNIVERSITY",68,18,0,7,86,79,2017,"LOUISIANA"
"83","LOUISVILLE, UNIVERSITY OF",38,20,0,6,58,52,2017,"KENTUCKY"
"84","LOYOLA MARYMOUNT UNIVERSITY-LOS ANGELES",112,75,0,38,187,149,2017,"CALIFORNIA"
"85","LOYOLA UNIVERSITY-CHICAGO",112,102,0,26,214,188,2017,"ILLINOIS"
"86","LOYOLA UNIVERSITY-NEW ORLEANS",49,39,0,15,88,73,2017,"LOUISIANA"
"87","MAINE, UNIVERSITY OF",42,33,0,7,75,68,2017,"MAINE"
"88","MARQUETTE UNIVERSITY",77,56,0,7,133,126,2017,"WISCONSIN"
"89","MARYLAND, UNIVERSITY OF",132,92,0,31,224,193,2017,"MARYLAND"
"90","MCGEORGE SCHOOL OF LAW",75,39,0,16,114,98,2017,"CALIFORNIA"
"91","MEMPHIS, UNIVERSITY OF",44,25,0,12,69,57,2017,"TENNESSEE"
"92","MERCER UNIVERSITY",50,20,0,5,70,65,2017,"GEORGIA"
"93","MIAMI, UNIVERSITY OF",132,72,0,45,204,159,2017,"FLORIDA"
"94","MICHIGAN STATE UNIVERSITY",83,49,0,15,132,117,2017,"MICHIGAN"
"95","MICHIGAN, UNIVERSITY OF",113,56,0,19,169,150,2017,"MICHIGAN"
"96","MINNESOTA, UNIVERSITY OF",138,74,0,15,212,197,2017,"MINNESOTA"
"97","MISSISSIPPI COLLEGE",56,32,0,11,88,77,2017,"MISSISSIPPI"
"98","MISSISSIPPI, UNIVERSITY OF",41,29,0,6,70,64,2017,"MISSISSIPPI"
"99","MISSOURI, UNIVERSITY OF",41,22,0,4,63,59,2017,"MISSOURI"
"100","MISSOURI-KANSAS CITY, UNIVERSITY OF",109,65,0,10,174,164,2017,"MISSOURI"
"101","MITCHELL | HAMLINE",114,115,0,18,229,211,2017,NA
"102","MONTANA, UNIVERSITY OF",27,25,0,8,52,44,2017,"MONTANA"
"103","NEBRASKA, UNIVERSITY OF",51,24,0,4,75,71,2017,"NEBRASKA"
"104","NEW ENGLAND LAW | BOSTON",71,50,0,8,121,113,2017,"MASSACHUSETTS"
"105","NEW HAMPSHIRE, UNIVERSITY OF",51,37,0,3,88,85,2017,"NEW HAMPSHIRE"
"106","NEW MEXICO, UNIVERSITY OF",55,49,0,35,104,69,2017,"NEW MEXICO"
"107","NEW YORK LAW SCHOOL",105,62,0,20,167,147,2017,"NEW YORK"
"108","NEW YORK UNIVERSITY",273,118,0,53,391,338,2017,"NEW YORK"
"109","NORTH CAROLINA CENTRAL UNIVERSITY",29,50,0,50,79,29,2017,"NORTH CAROLINA"
"110","NORTH CAROLINA, UNIVERSITY OF",79,67,0,21,146,125,2017,"NORTH CAROLINA"
"111","NORTH DAKOTA, UNIVERSITY OF",16,18,0,2,34,32,2017,"NORTH DAKOTA"
"112","NORTHEASTERN UNIVERSITY SCHOOL OF LAW",46,52,1,18,99,81,2017,NA
"113","NORTHERN ILLINOIS UNIVERSITY",27,19,0,8,46,38,2017,"ILLINOIS"
"114","NORTHERN KENTUCKY UNIVERSITY",47,23,0,8,70,62,2017,"KENTUCKY"
"115","NORTHWESTERN UNIVERSITY",234,118,0,36,352,316,2017,"ILLINOIS"
"116","NOTRE DAME, UNIVERSITY OF",100,53,0,12,153,141,2017,"INDIANA"
"117","NOVA SOUTHEASTERN UNIVERSITY",53,45,0,21,98,77,2017,"FLORIDA"
"118","OHIO NORTHERN UNIVERSITY",23,15,0,5,38,33,2017,"OHIO"
"119","OHIO STATE UNIVERSITY",75,38,0,14,113,99,2017,"OHIO"
"120","OKLAHOMA CITY UNIVERSITY",72,33,0,16,105,89,2017,"OKLAHOMA"
"121","OKLAHOMA, UNIVERSITY OF",52,28,0,11,80,69,2017,"OKLAHOMA"
"122","OREGON, UNIVERSITY OF",45,43,0,11,88,77,2017,"OREGON"
"123","PACE UNIVERSITY",81,46,0,16,127,111,2017,"NEW YORK"
"124","PENNSYLVANIA STATE - DICKINSON LAW",24,22,0,6,46,40,2017,"PENNSYLVANIA"
"125","PENNSYLVANIA STATE - PENN STATE LAW",36,21,0,8,57,49,2017,"PENNSYLVANIA"
"126","PENNSYLVANIA, UNIVERSITY OF",158,88,0,46,246,200,2017,"PENNSYLVANIA"
"127","PEPPERDINE UNIVERSITY",92,40,0,17,132,115,2017,"CALIFORNIA"
"128","PITTSBURGH, UNIVERSITY OF",124,66,0,16,190,174,2017,"PENNSYLVANIA"
"129","PONTIFICAL CATHOLIC UNIVERSITY OF P.R.",51,19,0,69,70,1,2017,"PUERTO RICO"
"130","PUERTO RICO, UNIVERSITY OF",71,59,1,127,131,4,2017,"PUERTO RICO"
"131","QUINNIPIAC UNIVERSITY",56,39,0,7,95,88,2017,"CONNECTICUT"
"132","REGENT UNIVERSITY",38,15,0,4,53,49,2017,"VIRGINIA"
"133","RICHMOND, UNIVERSITY OF",85,68,0,13,153,140,2017,"VIRGINIA"
"134","ROGER WILLIAMS UNIVERSITY",48,43,0,9,91,82,2017,"RHODE ISLAND"
"135","RUTGERS UNIVERSITY",193,115,0,54,308,254,2017,"NEW JERSEY"
"136","SAINT LOUIS UNIVERSITY",106,81,0,16,187,171,2017,"MISSOURI"
"137","SAMFORD UNIVERSITY",45,25,0,10,70,60,2017,"ALABAMA"
"138","SAN DIEGO, UNIVERSITY OF",107,53,0,17,160,143,2017,"CALIFORNIA"
"139","SAN FRANCISCO, UNIVERSITY OF",60,44,0,28,104,76,2017,"CALIFORNIA"
"140","SANTA CLARA UNIVERSITY",85,69,14,26,168,142,2017,"CALIFORNIA"
"141","SEATTLE UNIVERSITY",116,97,0,40,213,173,2017,"WASHINGTON"
"142","SETON HALL UNIVERSITY",65,49,0,11,114,103,2017,"NEW JERSEY"
"143","SOUTH CAROLINA, UNIVERSITY OF",64,45,0,10,109,99,2017,"SOUTH CAROLINA"
"144","SOUTH DAKOTA, UNIVERSITY OF",23,9,0,3,32,29,2017,"SOUTH DAKOTA"
"145","SOUTH TEXAS COLLEGE OF LAW HOUSTON",68,34,0,17,102,85,2017,"TEXAS"
"146","SOUTHERN CALIFORNIA, UNIVERSITY OF",124,63,0,27,187,160,2017,"CALIFORNIA"
"147","SOUTHERN ILLINOIS UNIVERSITY-CARBONDALE",23,31,0,5,54,49,2017,"ILLINOIS"
"148","SOUTHERN METHODIST UNIVERSITY",141,61,1,17,203,186,2017,"TEXAS"
"149","SOUTHERN UNIVERSITY",41,37,0,57,78,21,2017,"LOUISIANA"
"150","SOUTHWESTERN LAW SCHOOL",84,63,0,39,147,108,2017,"CALIFORNIA"
"151","ST. JOHN'S UNIVERSITY",85,51,0,18,136,118,2017,"NEW YORK"
"152","ST. MARY'S UNIVERSITY",80,44,0,25,124,99,2017,"TEXAS"
"153","ST. THOMAS UNIVERSITY (FLORIDA)",68,40,0,32,108,76,2017,"FLORIDA"
"154","ST. THOMAS, UNIVERSITY OF (MINNESOTA)",79,40,0,15,119,104,2017,"MINNESOTA"
"155","STANFORD UNIVERSITY",130,88,0,42,218,176,2017,"CALIFORNIA"
"156","STETSON UNIVERSITY",91,64,0,20,155,135,2017,"FLORIDA"
"157","SUFFOLK UNIVERSITY",98,73,0,20,171,151,2017,"MASSACHUSETTS"
"158","SYRACUSE UNIVERSITY",56,40,0,12,96,84,2017,"NEW YORK"
"159","TEMPLE UNIVERSITY",117,84,1,37,202,165,2017,"PENNSYLVANIA"
"160","TENNESSEE, UNIVERSITY OF",75,55,0,10,130,120,2017,"TENNESSEE"
"161","TEXAS A&M UNIVERSITY",73,45,0,20,118,98,2017,"TEXAS"
"162","TEXAS AT AUSTIN, UNIVERSITY OF",175,84,0,26,259,233,2017,"TEXAS"
"163","TEXAS SOUTHERN UNIVERSITY THURGOOD MARSHALL SCHOOL OF LAW",29,33,0,50,62,12,2017,NA
"164","TEXAS TECH UNIVERSITY",44,28,0,12,72,60,2017,"TEXAS"
"165","TOLEDO, UNIVERSITY OF",39,22,0,7,61,54,2017,"OHIO"
"166","TOURO UNIVERSITY",56,44,0,8,100,92,2017,"NEW YORK"
"167","TULANE UNIVERSITY",93,42,0,8,135,127,2017,"LOUISIANA"
"168","TULSA, UNIVERSITY OF",23,28,0,5,51,46,2017,"OKLAHOMA"
"169","UNIVERSITY OF BUFFALO-SUNY",83,55,0,8,138,130,2017,"NEW YORK"
"170","UNIVERSITY OF CALIFORNIA COLLEGE OF THE LAW, SAN FRANCISCO",134,99,0,43,233,190,2017,"CALIFORNIA"
"171","UNIVERSITY OF ILLINOIS CHICAGO SCHOOL OF LAW",160,89,0,32,249,217,2017,"ILLINOIS"
"172","UNIVERSITY OF MASSACHUSETTS DARTMOUTH",24,17,0,5,41,36,2017,"MASSACHUSETTS"
"173","UNIVERSITY OF NEVADA - LAS VEGAS",53,43,0,19,96,77,2017,"NEVADA"
"174","UTAH, UNIVERSITY OF",51,34,0,9,85,76,2017,"UTAH"
"175","VANDERBILT UNIVERSITY",91,51,0,16,143,127,2017,"TENNESSEE"
"176","VERMONT LAW SCHOOL",85,64,0,10,149,139,2017,"VERMONT"
"177","VILLANOVA UNIVERSITY",68,45,0,11,113,102,2017,"PENNSYLVANIA"
"178","VIRGINIA, UNIVERSITY OF",182,64,0,18,246,228,2017,"VIRGINIA"
"179","WAKE FOREST UNIVERSITY",79,41,0,13,120,107,2017,"NORTH CAROLINA"
"180","WASHBURN UNIVERSITY",40,31,0,5,71,66,2017,"KANSAS"
"181","WASHINGTON AND LEE UNIVERSITY",73,27,0,10,100,90,2017,"VIRGINIA"
"182","WASHINGTON UNIVERSITY",124,75,0,20,199,179,2017,"MISSOURI"
"183","WASHINGTON, UNIVERSITY OF",117,72,0,23,189,166,2017,"WASHINGTON"
"184","WAYNE STATE UNIVERSITY",54,33,0,9,87,78,2017,"MICHIGAN"
"185","WEST VIRGINIA UNIVERSITY",41,23,0,5,64,59,2017,"WEST VIRGINIA"
"186","COOLEY LAW SCHOOL",156,79,0,30,235,205,2017,NA
"187","WESTERN NEW ENGLAND UNIVERSITY",37,28,0,7,65,58,2017,"MASSACHUSETTS"
"188","WESTERN STATE COLLEGE OF LAW",31,21,0,15,52,37,2017,"CALIFORNIA"
"189","WIDENER UNIVERSITY-DELAWARE",42,28,0,7,70,63,2017,"DELAWARE"
"190","WIDENER-COMMONWEALTH",32,16,0,3,48,45,2017,"PENNSYLVANIA"
"191","WILLAMETTE UNIVERSITY",36,21,0,5,57,52,2017,"OREGON"
"192","WILLIAM AND MARY LAW SCHOOL",110,58,0,13,168,155,2017,"VIRGINIA"
"193","WISCONSIN, UNIVERSITY OF",72,62,0,21,134,113,2017,"WISCONSIN"
"194","WYOMING, UNIVERSITY OF",20,16,0,6,36,30,2017,"WYOMING"
"195","YALE UNIVERSITY",178,81,0,31,259,228,2017,"CONNECTICUT"
"196","AKRON, UNIVERSITY OF",45,28,0,8,73,65,2018,"OHIO"
"197","ALABAMA, UNIVERSITY OF",70,33,0,12,103,91,2018,"ALABAMA"
"198","ALBANY LAW SCHOOL",42,31,0,9,73,64,2018,"NEW YORK"
"199","AMERICAN UNIVERSITY",221,145,0,74,366,292,2018,"DISTRICT OF COLUMBIA"
"200","APPALACHIAN SCHOOL OF LAW",15,6,0,2,21,19,2018,"VIRGINIA"
"201","ARIZONA STATE UNIVERSITY",142,66,0,40,208,168,2018,"ARIZONA"
"202","ARIZONA, UNIVERSITY OF",95,60,0,25,155,130,2018,"ARIZONA"
"203","ARKANSAS, FAYETTEVILLE, UNIVERSITY OF",46,34,0,10,80,70,2018,"ARKANSAS"
"204","ARKANSAS, LITTLE ROCK, UNIVERSITY OF",60,47,0,18,107,89,2018,"ARKANSAS"
"205","ATLANTA'S JOHN MARSHALL LAW SCHOOL",30,29,0,15,59,44,2018,"GEORGIA"
"206","AVE MARIA SCHOOL OF LAW",28,13,0,2,41,39,2018,"FLORIDA"
"207","BALTIMORE, UNIVERSITY OF",89,65,0,23,154,131,2018,"MARYLAND"
"208","BARRY UNIVERSITY",50,33,0,20,83,63,2018,"FLORIDA"
"209","BAYLOR UNIVERSITY",60,24,0,6,84,78,2018,"TEXAS"
"210","BELMONT UNIVERSITY",26,14,0,5,40,35,2018,"TENNESSEE"
"211","BOSTON COLLEGE",74,54,0,25,128,103,2018,"MASSACHUSETTS"
"212","BOSTON UNIVERSITY",127,71,0,21,198,177,2018,"MASSACHUSETTS"
"213","BRIGHAM YOUNG UNIVERSITY",63,25,0,6,88,82,2018,"UTAH"
"214","BROOKLYN LAW SCHOOL",148,82,0,23,230,207,2018,"NEW YORK"
"215","CALIFORNIA WESTERN SCHOOL OF LAW",66,53,0,17,119,102,2018,"CALIFORNIA"
"216","CALIFORNIA-BERKELEY, UNIVERSITY OF",162,113,0,50,275,225,2018,"CALIFORNIA"
"217","CALIFORNIA-DAVIS, UNIVERSITY OF",54,43,0,37,97,60,2018,"CALIFORNIA"
"218","CALIFORNIA-IRVINE, UNIVERSITY OF",61,58,0,29,119,90,2018,"CALIFORNIA"
"219","CALIFORNIA-LOS ANGELES, UNIVERSITY OF",120,101,0,43,221,178,2018,"CALIFORNIA"
"220","CAMPBELL UNIVERSITY",61,29,0,11,90,79,2018,"NORTH CAROLINA"
"221","CAPITAL UNIVERSITY",56,27,0,9,83,74,2018,"OHIO"
"222","CARDOZO SCHOOL OF LAW",155,114,0,27,269,242,2018,"NEW YORK"
"223","CASE WESTERN RESERVE UNIVERSITY",68,27,0,9,95,86,2018,"OHIO"
"224","CATHOLIC UNIVERSITY OF AMERICA",59,40,0,13,99,86,2018,"DISTRICT OF COLUMBIA"
"225","CHAPMAN UNIVERSITY",67,43,0,8,110,102,2018,"CALIFORNIA"
"226","CHARLESTON SCHOOL OF LAW",48,33,0,2,81,79,2018,"SOUTH CAROLINA"
"227","CHICAGO, UNIVERSITY OF",128,58,0,25,186,161,2018,"ILLINOIS"
"228","CHICAGO-KENT COLLEGE OF LAW-IIT",136,48,0,24,184,160,2018,"ILLINOIS"
"229","CINCINNATI, UNIVERSITY OF",39,28,19,10,86,76,2018,"OHIO"
"230","CITY UNIVERSITY OF NEW YORK",28,51,0,29,79,50,2018,"NEW YORK"
"231","CLEVELAND STATE UNIVERSITY",52,35,0,14,87,73,2018,"OHIO"
"232","COLORADO, UNIVERSITY OF",74,48,0,22,122,100,2018,"COLORADO"
"233","COLUMBIA UNIVERSITY",269,133,0,49,402,353,2018,"NEW YORK"
"234","CONNECTICUT, UNIVERSITY OF",99,58,0,18,157,139,2018,"CONNECTICUT"
"235","CORNELL UNIVERSITY",95,51,0,17,146,129,2018,"NEW YORK"
"236","CREIGHTON UNIVERSITY",43,16,0,5,59,54,2018,"NEBRASKA"
"237","DAYTON, UNIVERSITY OF",43,26,0,8,69,61,2018,"OHIO"
"238","DENVER, UNIVERSITY OF",103,66,1,23,170,147,2018,"COLORADO"
"239","DEPAUL UNIVERSITY",80,67,0,30,147,117,2018,"ILLINOIS"
"240","DETROIT MERCY, UNIVERSITY OF",54,42,0,15,96,81,2018,"MICHIGAN"
"241","DISTRICT OF COLUMBIA",29,39,0,32,68,36,2018,"DISTRICT OF COLUMBIA"
"242","DRAKE UNIVERSITY",39,31,0,5,70,65,2018,"IOWA"
"243","DREXEL UNIVERSITY",67,65,0,27,132,105,2018,"PENNSYLVANIA"
"244","DUKE UNIVERSITY",117,64,0,21,181,160,2018,"NORTH CAROLINA"
"245","DUQUESNE UNIVERSITY",64,33,0,9,97,88,2018,"PENNSYLVANIA"
"246","ELON UNIVERSITY",37,35,0,8,72,64,2018,"NORTH CAROLINA"
"247","EMORY UNIVERSITY",113,80,9,27,202,175,2018,"GEORGIA"
"248","FAULKNER UNIVERSITY",23,10,0,4,33,29,2018,"ALABAMA"
"249","FLORIDA A&M UNIVERSITY",32,40,0,49,72,23,2018,"FLORIDA"
"250","FLORIDA INTERNATIONAL UNIVERSITY",59,30,0,44,89,45,2018,"FLORIDA"
"251","FLORIDA STATE UNIVERSITY",74,41,0,16,115,99,2018,"FLORIDA"
"252","FLORIDA, UNIVERSITY OF",190,129,0,57,319,262,2018,"FLORIDA"
"253","FORDHAM UNIVERSITY",220,138,0,47,358,311,2018,"NEW YORK"
"254","GEORGE MASON UNIVERSITY",148,64,0,32,212,180,2018,"VIRGINIA"
"255","GEORGE WASHINGTON UNIVERSITY",344,147,0,68,491,423,2018,"DISTRICT OF COLUMBIA"
"256","GEORGETOWN UNIVERSITY",557,255,3,35,815,780,2018,"DISTRICT OF COLUMBIA"
"257","GEORGIA STATE UNIVERSITY",73,63,0,20,137,117,2018,"GEORGIA"
"258","GEORGIA, UNIVERSITY OF",58,43,0,16,101,85,2018,"GEORGIA"
"259","GOLDEN GATE UNIVERSITY",60,62,0,25,122,97,2018,"CALIFORNIA"
"260","GONZAGA UNIVERSITY",41,25,0,7,66,59,2018,"WASHINGTON"
"261","HARVARD UNIVERSITY",229,111,0,56,340,284,2018,"MASSACHUSETTS"
"262","HAWAII, UNIVERSITY OF",60,55,0,48,115,67,2018,"HAWAII"
"263","HOFSTRA UNIVERSITY",93,60,0,9,153,144,2018,"NEW YORK"
"264","HOUSTON, UNIVERSITY OF",161,92,0,45,253,208,2018,"TEXAS"
"265","HOWARD UNIVERSITY",41,40,0,65,81,16,2018,"DISTRICT OF COLUMBIA"
"266","IDAHO, UNIVERSITY OF",42,29,0,9,71,62,2018,"IDAHO"
"267","ILLINOIS, UNIVERSITY OF",76,57,0,20,133,113,2018,"ILLINOIS"
"268","INDIANA UNIVERSITY - BLOOMINGTON",79,43,0,14,122,108,2018,"INDIANA"
"269","INDIANA UNIVERSITY - INDIANAPOLIS",82,68,1,14,151,137,2018,"INDIANA"
"270","INTER AMERICAN UNIVERSITY OF PUERTO RICO",67,31,0,94,98,4,2018,"PUERTO RICO"
"271","IOWA, UNIVERSITY OF",49,36,0,11,85,74,2018,"IOWA"
"272","KANSAS, UNIVERSITY OF",44,30,0,7,74,67,2018,"KANSAS"
"273","KENTUCKY, UNIVERSITY OF",41,34,0,5,75,70,2018,"KENTUCKY"
"274","LEWIS AND CLARK COLLEGE",86,58,0,19,144,125,2018,"OREGON"
"275","LIBERTY UNIVERSITY",26,9,0,7,35,28,2018,"VIRGINIA"
"276","LINCOLN MEMORIAL",19,11,0,3,30,27,2018,"DISTRICT OF COLUMBIA"
"277","LOUISIANA STATE UNIVERSITY",65,18,0,8,83,75,2018,"LOUISIANA"
"278","LOUISVILLE, UNIVERSITY OF",41,20,0,8,61,53,2018,"KENTUCKY"
"279","LOYOLA MARYMOUNT UNIVERSITY-LOS ANGELES",113,79,0,41,192,151,2018,"CALIFORNIA"
"280","LOYOLA UNIVERSITY-CHICAGO",103,100,0,24,203,179,2018,"ILLINOIS"
"281","LOYOLA UNIVERSITY-NEW ORLEANS",58,38,0,19,96,77,2018,"LOUISIANA"
"282","MAINE, UNIVERSITY OF",31,27,0,5,58,53,2018,"MAINE"
"283","MARQUETTE UNIVERSITY",75,45,0,10,120,110,2018,"WISCONSIN"
"284","MARYLAND, UNIVERSITY OF",101,70,0,24,171,147,2018,"MARYLAND"
"285","MCGEORGE SCHOOL OF LAW",69,36,0,12,105,93,2018,"CALIFORNIA"
"286","MEMPHIS, UNIVERSITY OF",40,18,0,7,58,51,2018,"TENNESSEE"
"287","MERCER UNIVERSITY",49,23,0,6,72,66,2018,"GEORGIA"
"288","MIAMI, UNIVERSITY OF",111,65,0,35,176,141,2018,"FLORIDA"
"289","MICHIGAN STATE UNIVERSITY",78,46,0,14,124,110,2018,"MICHIGAN"
"290","MICHIGAN, UNIVERSITY OF",122,76,1,21,199,178,2018,"MICHIGAN"
"291","MINNESOTA, UNIVERSITY OF",131,69,0,15,200,185,2018,"MINNESOTA"
"292","MISSISSIPPI COLLEGE",40,30,0,11,70,59,2018,"MISSISSIPPI"
"293","MISSISSIPPI, UNIVERSITY OF",41,29,0,6,70,64,2018,"MISSISSIPPI"
"294","MISSOURI, UNIVERSITY OF",33,24,0,4,57,53,2018,"MISSOURI"
"295","MISSOURI-KANSAS CITY, UNIVERSITY OF",72,44,0,8,116,108,2018,"MISSOURI"
"296","MITCHELL | HAMLINE",138,133,0,29,271,242,2018,NA
"297","MONTANA, UNIVERSITY OF",26,28,0,5,54,49,2018,"MONTANA"
"298","NEBRASKA, UNIVERSITY OF",50,23,0,4,73,69,2018,"NEBRASKA"
"299","NEW ENGLAND LAW | BOSTON",59,48,0,10,107,97,2018,"MASSACHUSETTS"
"300","NEW HAMPSHIRE, UNIVERSITY OF",41,37,0,3,78,75,2018,"NEW HAMPSHIRE"
"301","NEW MEXICO, UNIVERSITY OF",49,50,0,33,99,66,2018,"NEW MEXICO"
"302","NEW YORK LAW SCHOOL",103,77,0,21,180,159,2018,"NEW YORK"
"303","NEW YORK UNIVERSITY",310,145,0,65,455,390,2018,"NEW YORK"
"304","NORTH CAROLINA CENTRAL UNIVERSITY",32,46,0,43,78,35,2018,"NORTH CAROLINA"
"305","NORTH CAROLINA, UNIVERSITY OF",65,56,0,18,121,103,2018,"NORTH CAROLINA"
"306","NORTH DAKOTA, UNIVERSITY OF",10,14,0,1,24,23,2018,"NORTH DAKOTA"
"307","NORTHEASTERN UNIVERSITY SCHOOL OF LAW",41,54,0,15,95,80,2018,NA
"308","NORTHERN ILLINOIS UNIVERSITY",22,21,0,7,43,36,2018,"ILLINOIS"
"309","NORTHERN KENTUCKY UNIVERSITY",52,20,0,7,72,65,2018,"KENTUCKY"
"310","NORTHWESTERN UNIVERSITY",162,90,0,26,252,226,2018,"ILLINOIS"
"311","NOTRE DAME, UNIVERSITY OF",104,51,0,12,155,143,2018,"INDIANA"
"312","NOVA SOUTHEASTERN UNIVERSITY",52,43,0,23,95,72,2018,"FLORIDA"
"313","OHIO NORTHERN UNIVERSITY",17,15,0,3,32,29,2018,"OHIO"
"314","OHIO STATE UNIVERSITY",73,39,0,15,112,97,2018,"OHIO"
"315","OKLAHOMA CITY UNIVERSITY",47,24,0,9,71,62,2018,"OKLAHOMA"
"316","OKLAHOMA, UNIVERSITY OF",46,25,0,10,71,61,2018,"OKLAHOMA"
"317","OREGON, UNIVERSITY OF",51,44,0,10,95,85,2018,"OREGON"
"318","PACE UNIVERSITY",75,57,0,16,132,116,2018,"NEW YORK"
"319","PENNSYLVANIA STATE - DICKINSON LAW",25,26,0,10,51,41,2018,"PENNSYLVANIA"
"320","PENNSYLVANIA STATE - PENN STATE LAW",38,22,0,9,60,51,2018,"PENNSYLVANIA"
"321","PENNSYLVANIA, UNIVERSITY OF",156,86,0,48,242,194,2018,"PENNSYLVANIA"
"322","PEPPERDINE UNIVERSITY",95,44,0,21,139,118,2018,"CALIFORNIA"
"323","PITTSBURGH, UNIVERSITY OF",110,58,0,15,168,153,2018,"PENNSYLVANIA"
"324","PONTIFICAL CATHOLIC UNIVERSITY OF P.R.",51,19,0,69,70,1,2018,"PUERTO RICO"
"325","PUERTO RICO, UNIVERSITY OF",70,52,0,119,122,3,2018,"PUERTO RICO"
"326","QUINNIPIAC UNIVERSITY",61,37,0,6,98,92,2018,"CONNECTICUT"
"327","REGENT UNIVERSITY",28,10,0,6,38,32,2018,"VIRGINIA"
"328","RICHMOND, UNIVERSITY OF",78,61,0,11,139,128,2018,"VIRGINIA"
"329","ROGER WILLIAMS UNIVERSITY",52,41,0,8,93,85,2018,"RHODE ISLAND"
"330","RUTGERS UNIVERSITY",194,118,0,52,312,260,2018,"NEW JERSEY"
"331","SAINT LOUIS UNIVERSITY",59,45,0,10,104,94,2018,"MISSOURI"
"332","SAMFORD UNIVERSITY",39,19,0,7,58,51,2018,"ALABAMA"
"333","SAN DIEGO, UNIVERSITY OF",102,43,0,12,145,133,2018,"CALIFORNIA"
"334","SAN FRANCISCO, UNIVERSITY OF",62,50,0,24,112,88,2018,"CALIFORNIA"
"335","SANTA CLARA UNIVERSITY",92,76,10,37,178,141,2018,"CALIFORNIA"
"336","SEATTLE UNIVERSITY",93,73,0,37,166,129,2018,"WASHINGTON"
"337","SETON HALL UNIVERSITY",65,49,0,13,114,101,2018,"NEW JERSEY"
"338","SOUTH CAROLINA, UNIVERSITY OF",68,39,0,7,107,100,2018,"SOUTH CAROLINA"
"339","SOUTH DAKOTA, UNIVERSITY OF",23,10,0,3,33,30,2018,"SOUTH DAKOTA"
"340","SOUTH TEXAS COLLEGE OF LAW HOUSTON",66,41,0,16,107,91,2018,"TEXAS"
"341","SOUTHERN CALIFORNIA, UNIVERSITY OF",129,55,0,26,184,158,2018,"CALIFORNIA"
"342","SOUTHERN ILLINOIS UNIVERSITY-CARBONDALE",22,21,0,5,43,38,2018,"ILLINOIS"
"343","SOUTHERN METHODIST UNIVERSITY",143,67,1,21,211,190,2018,"TEXAS"
"344","SOUTHERN UNIVERSITY",59,54,0,85,113,28,2018,"LOUISIANA"
"345","SOUTHWESTERN LAW SCHOOL",80,59,0,37,139,102,2018,"CALIFORNIA"
"346","ST. JOHN'S UNIVERSITY",95,58,0,21,153,132,2018,"NEW YORK"
"347","ST. MARY'S UNIVERSITY",76,41,0,28,117,89,2018,"TEXAS"
"348","ST. THOMAS UNIVERSITY (FLORIDA)",49,32,0,22,81,59,2018,"FLORIDA"
"349","ST. THOMAS, UNIVERSITY OF (MINNESOTA)",87,42,0,15,129,114,2018,"MINNESOTA"
"350","STANFORD UNIVERSITY",125,85,0,39,210,171,2018,"CALIFORNIA"
"351","STETSON UNIVERSITY",67,67,2,16,136,120,2018,"FLORIDA"
"352","SUFFOLK UNIVERSITY",95,72,0,20,167,147,2018,"MASSACHUSETTS"
"353","SYRACUSE UNIVERSITY",61,31,0,11,92,81,2018,"NEW YORK"
"354","TEMPLE UNIVERSITY",115,72,2,33,189,156,2018,"PENNSYLVANIA"
"355","TENNESSEE, UNIVERSITY OF",58,43,0,11,101,90,2018,"TENNESSEE"
"356","TEXAS A&M UNIVERSITY",61,42,0,17,103,86,2018,"TEXAS"
"357","TEXAS AT AUSTIN, UNIVERSITY OF",186,95,0,30,281,251,2018,"TEXAS"
"358","TEXAS SOUTHERN UNIVERSITY THURGOOD MARSHALL SCHOOL OF LAW",40,51,0,72,91,19,2018,NA
"359","TEXAS TECH UNIVERSITY",41,25,0,10,66,56,2018,"TEXAS"
"360","TOLEDO, UNIVERSITY OF",28,15,0,5,43,38,2018,"OHIO"
"361","TOURO UNIVERSITY",57,37,0,10,94,84,2018,"NEW YORK"
"362","TULANE UNIVERSITY",108,40,0,9,148,139,2018,"LOUISIANA"
"363","TULSA, UNIVERSITY OF",28,27,0,5,55,50,2018,"OKLAHOMA"
"364","UNIVERSITY OF BUFFALO-SUNY",75,55,0,11,130,119,2018,"NEW YORK"
"365","UNIVERSITY OF CALIFORNIA COLLEGE OF THE LAW, SAN FRANCISCO",147,106,0,43,253,210,2018,"CALIFORNIA"
"366","UNIVERSITY OF ILLINOIS CHICAGO SCHOOL OF LAW",119,76,0,38,195,157,2018,"ILLINOIS"
"367","UNIVERSITY OF MASSACHUSETTS DARTMOUTH",23,17,0,2,40,38,2018,"MASSACHUSETTS"
"368","UNIVERSITY OF NEVADA - LAS VEGAS",53,39,0,16,92,76,2018,"NEVADA"
"369","UTAH, UNIVERSITY OF",57,41,0,11,98,87,2018,"UTAH"
"370","VANDERBILT UNIVERSITY",81,49,0,20,130,110,2018,"TENNESSEE"
"371","VERMONT LAW SCHOOL",94,73,0,9,167,158,2018,"VERMONT"
"372","VILLANOVA UNIVERSITY",68,47,0,10,115,105,2018,"PENNSYLVANIA"
"373","VIRGINIA, UNIVERSITY OF",167,70,0,23,237,214,2018,"VIRGINIA"
"374","WAKE FOREST UNIVERSITY",89,47,0,13,136,123,2018,"NORTH CAROLINA"
"375","WASHBURN UNIVERSITY",36,34,0,7,70,63,2018,"KANSAS"
"376","WASHINGTON AND LEE UNIVERSITY",63,29,0,9,92,83,2018,"VIRGINIA"
"377","WASHINGTON UNIVERSITY",114,56,0,18,170,152,2018,"MISSOURI"
"378","WASHINGTON, UNIVERSITY OF",103,76,0,22,179,157,2018,"WASHINGTON"
"379","WAYNE STATE UNIVERSITY",40,33,0,10,73,63,2018,"MICHIGAN"
"380","WEST VIRGINIA UNIVERSITY",33,25,0,4,58,54,2018,"WEST VIRGINIA"
"381","COOLEY LAW SCHOOL",152,80,0,33,232,199,2018,NA
"382","WESTERN NEW ENGLAND UNIVERSITY",37,22,0,8,59,51,2018,"MASSACHUSETTS"
"383","WESTERN STATE COLLEGE OF LAW",36,27,0,16,63,47,2018,"CALIFORNIA"
"384","WIDENER UNIVERSITY-DELAWARE",37,37,0,6,74,68,2018,"DELAWARE"
"385","WIDENER-COMMONWEALTH",36,17,0,2,53,51,2018,"PENNSYLVANIA"
"386","WILLAMETTE UNIVERSITY",32,23,0,5,55,50,2018,"OREGON"
"387","WILLIAM AND MARY LAW SCHOOL",110,62,0,13,172,159,2018,"VIRGINIA"
"388","WISCONSIN, UNIVERSITY OF",61,55,0,17,116,99,2018,"WISCONSIN"
"389","WYOMING, UNIVERSITY OF",22,18,0,6,40,34,2018,"WYOMING"
"390","YALE UNIVERSITY",167,90,0,30,257,227,2018,"CONNECTICUT"
"391","AKRON, UNIVERSITY OF",37,28,0,6,65,59,2019,"OHIO"
"392","ALABAMA, UNIVERSITY OF",68,33,0,15,101,86,2019,"ALABAMA"
"393","ALBANY LAW SCHOOL",53,41,0,15,94,79,2019,"NEW YORK"
"394","AMERICAN UNIVERSITY",177,137,0,63,314,251,2019,"DISTRICT OF COLUMBIA"
"395","APPALACHIAN SCHOOL OF LAW",16,7,0,2,23,21,2019,"VIRGINIA"
"396","ARIZONA STATE UNIVERSITY",141,64,0,37,205,168,2019,"ARIZONA"
"397","ARIZONA, UNIVERSITY OF",77,62,0,25,139,114,2019,"ARIZONA"
"398","ARKANSAS, FAYETTEVILLE, UNIVERSITY OF",41,33,0,8,74,66,2019,"ARKANSAS"
"399","ARKANSAS, LITTLE ROCK, UNIVERSITY OF",43,47,0,12,90,78,2019,"ARKANSAS"
"400","ATLANTA'S JOHN MARSHALL LAW SCHOOL",25,26,0,11,51,40,2019,"GEORGIA"
"401","AVE MARIA SCHOOL OF LAW",26,15,0,2,41,39,2019,"FLORIDA"
"402","BALTIMORE, UNIVERSITY OF",76,58,0,25,134,109,2019,"MARYLAND"
"403","BARRY UNIVERSITY",45,36,0,22,81,59,2019,"FLORIDA"
"404","BAYLOR UNIVERSITY",93,45,0,10,138,128,2019,"TEXAS"
"405","BELMONT UNIVERSITY",25,15,0,6,40,34,2019,"TENNESSEE"
"406","BOSTON COLLEGE",79,70,0,26,149,123,2019,"MASSACHUSETTS"
"407","BOSTON UNIVERSITY",130,81,0,13,211,198,2019,"MASSACHUSETTS"
"408","BRIGHAM YOUNG UNIVERSITY",66,28,0,6,94,88,2019,"UTAH"
"409","BROOKLYN LAW SCHOOL",127,84,0,30,211,181,2019,"NEW YORK"
"410","CALIFORNIA WESTERN SCHOOL OF LAW",59,55,0,22,114,92,2019,"CALIFORNIA"
"411","CALIFORNIA-BERKELEY, UNIVERSITY OF",170,120,1,53,291,238,2019,"CALIFORNIA"
"412","CALIFORNIA-DAVIS, UNIVERSITY OF",71,50,0,39,121,82,2019,"CALIFORNIA"
"413","CALIFORNIA-IRVINE, UNIVERSITY OF",60,70,0,27,130,103,2019,"CALIFORNIA"
"414","CALIFORNIA-LOS ANGELES, UNIVERSITY OF",120,93,0,49,213,164,2019,"CALIFORNIA"
"415","CAMPBELL UNIVERSITY",65,35,0,18,100,82,2019,"NORTH CAROLINA"
"416","CAPITAL UNIVERSITY",52,24,0,9,76,67,2019,"OHIO"
"417","CARDOZO SCHOOL OF LAW",197,138,0,25,335,310,2019,"NEW YORK"
"418","CASE WESTERN RESERVE UNIVERSITY",72,23,0,8,95,87,2019,"OHIO"
"419","CATHOLIC UNIVERSITY OF AMERICA",67,30,0,8,97,89,2019,"DISTRICT OF COLUMBIA"
"420","CHAPMAN UNIVERSITY",68,50,0,19,118,99,2019,"CALIFORNIA"
"421","CHARLESTON SCHOOL OF LAW",48,35,0,2,83,81,2019,"SOUTH CAROLINA"
"422","CHICAGO, UNIVERSITY OF",130,58,0,31,188,157,2019,"ILLINOIS"
"423","CHICAGO-KENT COLLEGE OF LAW-IIT",129,44,0,29,173,144,2019,"ILLINOIS"
"424","CINCINNATI, UNIVERSITY OF",51,33,8,8,92,84,2019,"OHIO"
"425","CITY UNIVERSITY OF NEW YORK",33,62,0,39,95,56,2019,"NEW YORK"
"426","CLEVELAND STATE UNIVERSITY",61,31,0,14,92,78,2019,"OHIO"
"427","COLORADO, UNIVERSITY OF",75,46,1,24,122,98,2019,"COLORADO"
"428","COLUMBIA UNIVERSITY",252,157,0,62,409,347,2019,"NEW YORK"
"429","CONNECTICUT, UNIVERSITY OF",103,56,0,21,159,138,2019,"CONNECTICUT"
"430","CORNELL UNIVERSITY",112,54,0,23,166,143,2019,"NEW YORK"
"431","CREIGHTON UNIVERSITY",36,20,0,5,56,51,2019,"NEBRASKA"
"432","DAYTON, UNIVERSITY OF",39,32,0,12,71,59,2019,"OHIO"
"433","DENVER, UNIVERSITY OF",86,64,0,24,150,126,2019,"COLORADO"
"434","DEPAUL UNIVERSITY",80,67,0,30,147,117,2019,"ILLINOIS"
"435","DETROIT MERCY, UNIVERSITY OF",44,42,0,12,86,74,2019,"MICHIGAN"
"436","DISTRICT OF COLUMBIA",23,37,0,27,60,33,2019,"DISTRICT OF COLUMBIA"
"437","DRAKE UNIVERSITY",48,32,0,7,80,73,2019,"IOWA"
"438","DREXEL UNIVERSITY",67,67,0,26,134,108,2019,"PENNSYLVANIA"
"439","DUKE UNIVERSITY",115,79,0,26,194,168,2019,"NORTH CAROLINA"
"440","DUQUESNE UNIVERSITY",54,40,0,10,94,84,2019,"PENNSYLVANIA"
"441","ELON UNIVERSITY",31,34,0,6,65,59,2019,"NORTH CAROLINA"
"442","EMORY UNIVERSITY",105,89,0,34,194,160,2019,"GEORGIA"
"443","FAULKNER UNIVERSITY",20,10,0,4,30,26,2019,"ALABAMA"
"444","FLORIDA A&M UNIVERSITY",30,35,0,48,65,17,2019,"FLORIDA"
"445","FLORIDA INTERNATIONAL UNIVERSITY",63,38,0,48,101,53,2019,"FLORIDA"
"446","FLORIDA STATE UNIVERSITY",67,41,0,12,108,96,2019,"FLORIDA"
"447","FLORIDA, UNIVERSITY OF",229,156,0,53,385,332,2019,"FLORIDA"
"448","FORDHAM UNIVERSITY",239,162,0,57,401,344,2019,"NEW YORK"
"449","GEORGE MASON UNIVERSITY",149,64,0,27,213,186,2019,"VIRGINIA"
"450","GEORGE WASHINGTON UNIVERSITY",332,142,0,64,474,410,2019,"DISTRICT OF COLUMBIA"
"451","GEORGETOWN UNIVERSITY",553,282,7,46,842,796,2019,"DISTRICT OF COLUMBIA"
"452","GEORGIA STATE UNIVERSITY",69,70,0,25,139,114,2019,"GEORGIA"
"453","GEORGIA, UNIVERSITY OF",68,46,0,16,114,98,2019,"GEORGIA"
"454","GOLDEN GATE UNIVERSITY",72,64,0,29,136,107,2019,"CALIFORNIA"
"455","GONZAGA UNIVERSITY",48,29,0,10,77,67,2019,"WASHINGTON"
"456","HARVARD UNIVERSITY",221,118,1,62,340,278,2019,"MASSACHUSETTS"
"457","HAWAII, UNIVERSITY OF",64,50,0,48,114,66,2019,"HAWAII"
"458","HOFSTRA UNIVERSITY",105,67,0,14,172,158,2019,"NEW YORK"
"459","HOUSTON, UNIVERSITY OF",144,75,0,38,219,181,2019,"TEXAS"
"460","HOWARD UNIVERSITY",45,44,0,73,89,16,2019,"DISTRICT OF COLUMBIA"
"461","IDAHO, UNIVERSITY OF",40,28,0,8,68,60,2019,"IDAHO"
"462","ILLINOIS, UNIVERSITY OF",75,53,0,19,128,109,2019,"ILLINOIS"
"463","INDIANA UNIVERSITY - BLOOMINGTON",70,44,0,16,114,98,2019,"INDIANA"
"464","INDIANA UNIVERSITY - INDIANAPOLIS",78,60,0,20,138,118,2019,"INDIANA"
"465","INTER AMERICAN UNIVERSITY OF PUERTO RICO",66,33,0,96,99,3,2019,"PUERTO RICO"
"466","IOWA, UNIVERSITY OF",49,31,0,7,80,73,2019,"IOWA"
"467","KANSAS, UNIVERSITY OF",43,29,0,7,72,65,2019,"KANSAS"
"468","KENTUCKY, UNIVERSITY OF",42,35,0,5,77,72,2019,"KENTUCKY"
"469","LEWIS AND CLARK COLLEGE",82,56,0,20,138,118,2019,"OREGON"
"470","LIBERTY UNIVERSITY",24,7,0,6,31,25,2019,"VIRGINIA"
"471","LINCOLN MEMORIAL",18,21,0,4,39,35,2019,"DISTRICT OF COLUMBIA"
"472","LOUISIANA STATE UNIVERSITY",59,27,0,8,86,78,2019,"LOUISIANA"
"473","LOUISVILLE, UNIVERSITY OF",43,23,0,9,66,57,2019,"KENTUCKY"
"474","LOYOLA MARYMOUNT UNIVERSITY-LOS ANGELES",100,80,5,43,185,142,2019,"CALIFORNIA"
"475","LOYOLA UNIVERSITY-CHICAGO",122,119,0,34,241,207,2019,"ILLINOIS"
"476","LOYOLA UNIVERSITY-NEW ORLEANS",49,35,0,21,84,63,2019,"LOUISIANA"
"477","MAINE, UNIVERSITY OF",36,28,0,5,64,59,2019,"MAINE"
"478","MARQUETTE UNIVERSITY",76,48,0,12,124,112,2019,"WISCONSIN"
"479","MARYLAND, UNIVERSITY OF",102,73,0,31,175,144,2019,"MARYLAND"
"480","MCGEORGE SCHOOL OF LAW",65,37,0,9,102,93,2019,"CALIFORNIA"
"481","MEMPHIS, UNIVERSITY OF",36,22,0,7,58,51,2019,"TENNESSEE"
"482","MERCER UNIVERSITY",47,20,0,6,67,61,2019,"GEORGIA"
"483","MIAMI, UNIVERSITY OF",164,101,0,52,265,213,2019,"FLORIDA"
"484","MICHIGAN STATE UNIVERSITY",73,51,0,11,124,113,2019,"MICHIGAN"
"485","MICHIGAN, UNIVERSITY OF",127,63,0,19,190,171,2019,"MICHIGAN"
"486","MINNESOTA, UNIVERSITY OF",137,77,0,15,214,199,2019,"MINNESOTA"
"487","MISSISSIPPI COLLEGE",33,22,0,10,55,45,2019,"MISSISSIPPI"
"488","MISSISSIPPI, UNIVERSITY OF",39,26,0,9,65,56,2019,"MISSISSIPPI"
"489","MISSOURI, UNIVERSITY OF",27,25,0,4,52,48,2019,"MISSOURI"
"490","MISSOURI-KANSAS CITY, UNIVERSITY OF",63,47,0,9,110,101,2019,"MISSOURI"
"491","MITCHELL | HAMLINE",139,140,0,34,279,245,2019,NA
"492","MONTANA, UNIVERSITY OF",14,18,0,3,32,29,2019,"MONTANA"
"493","NEBRASKA, UNIVERSITY OF",55,22,0,3,77,74,2019,"NEBRASKA"
"494","NEW ENGLAND LAW | BOSTON",59,41,0,6,100,94,2019,"MASSACHUSETTS"
"495","NEW HAMPSHIRE, UNIVERSITY OF",57,35,1,3,93,90,2019,"NEW HAMPSHIRE"
"496","NEW MEXICO, UNIVERSITY OF",51,51,0,33,102,69,2019,"NEW MEXICO"
"497","NEW YORK LAW SCHOOL",115,73,0,26,188,162,2019,"NEW YORK"
"498","NEW YORK UNIVERSITY",282,121,0,62,403,341,2019,"NEW YORK"
"499","NORTH CAROLINA CENTRAL UNIVERSITY",30,44,0,48,74,26,2019,"NORTH CAROLINA"
"500","NORTH CAROLINA, UNIVERSITY OF",138,108,0,34,246,212,2019,"NORTH CAROLINA"
"501","NORTH DAKOTA, UNIVERSITY OF",13,14,0,3,27,24,2019,"NORTH DAKOTA"
"502","NORTHEASTERN UNIVERSITY SCHOOL OF LAW",49,63,0,19,112,93,2019,NA
"503","NORTHERN ILLINOIS UNIVERSITY",33,21,0,12,54,42,2019,"ILLINOIS"
"504","NORTHERN KENTUCKY UNIVERSITY",41,17,0,10,58,48,2019,"KENTUCKY"
"505","NORTHWESTERN UNIVERSITY",157,83,0,31,240,209,2019,"ILLINOIS"
"506","NOTRE DAME, UNIVERSITY OF",108,53,0,13,161,148,2019,"INDIANA"
"507","NOVA SOUTHEASTERN UNIVERSITY",44,40,0,22,84,62,2019,"FLORIDA"
"508","OHIO NORTHERN UNIVERSITY",11,14,0,3,25,22,2019,"OHIO"
"509","OHIO STATE UNIVERSITY",80,43,0,14,123,109,2019,"OHIO"
"510","OKLAHOMA CITY UNIVERSITY",51,26,0,11,77,66,2019,"OKLAHOMA"
"511","OKLAHOMA, UNIVERSITY OF",43,29,0,9,72,63,2019,"OKLAHOMA"
"512","OREGON, UNIVERSITY OF",39,48,0,10,87,77,2019,"OREGON"
"513","PACE UNIVERSITY",69,54,0,16,123,107,2019,"NEW YORK"
"514","PENNSYLVANIA STATE - DICKINSON LAW",26,26,0,5,52,47,2019,"PENNSYLVANIA"
"515","PENNSYLVANIA STATE - PENN STATE LAW",41,25,0,11,66,55,2019,"PENNSYLVANIA"
"516","PENNSYLVANIA, UNIVERSITY OF",155,91,0,49,246,197,2019,"PENNSYLVANIA"
"517","PEPPERDINE UNIVERSITY",126,59,0,38,185,147,2019,"CALIFORNIA"
"518","PITTSBURGH, UNIVERSITY OF",103,56,0,16,159,143,2019,"PENNSYLVANIA"
"519","PONTIFICAL CATHOLIC UNIVERSITY OF P.R.",45,20,0,65,65,0,2019,"PUERTO RICO"
"520","PUERTO RICO, UNIVERSITY OF",68,52,0,118,120,2,2019,"PUERTO RICO"
"521","QUINNIPIAC UNIVERSITY",63,37,0,8,100,92,2019,"CONNECTICUT"
"522","REGENT UNIVERSITY",30,11,0,5,41,36,2019,"VIRGINIA"
"523","RICHMOND, UNIVERSITY OF",74,56,0,12,130,118,2019,"VIRGINIA"
"524","ROGER WILLIAMS UNIVERSITY",48,41,0,10,89,79,2019,"RHODE ISLAND"
"525","RUTGERS UNIVERSITY",120,95,0,36,215,179,2019,"NEW JERSEY"
"526","SAINT LOUIS UNIVERSITY",52,45,0,10,97,87,2019,"MISSOURI"
"527","SAMFORD UNIVERSITY",33,15,0,6,48,42,2019,"ALABAMA"
"528","SAN DIEGO, UNIVERSITY OF",108,56,0,14,164,150,2019,"CALIFORNIA"
"529","SAN FRANCISCO, UNIVERSITY OF",47,44,0,24,91,67,2019,"CALIFORNIA"
"530","SANTA CLARA UNIVERSITY",87,88,12,38,187,149,2019,"CALIFORNIA"
"531","SEATTLE UNIVERSITY",94,73,0,37,167,130,2019,"WASHINGTON"
"532","SETON HALL UNIVERSITY",74,60,0,25,134,109,2019,"NEW JERSEY"
"533","SOUTH CAROLINA, UNIVERSITY OF",67,38,0,10,105,95,2019,"SOUTH CAROLINA"
"534","SOUTH DAKOTA, UNIVERSITY OF",19,11,0,6,30,24,2019,"SOUTH DAKOTA"
"535","SOUTH TEXAS COLLEGE OF LAW HOUSTON",66,37,0,19,103,84,2019,"TEXAS"
"536","SOUTHERN CALIFORNIA, UNIVERSITY OF",123,63,0,27,186,159,2019,"CALIFORNIA"
"537","SOUTHERN ILLINOIS UNIVERSITY-CARBONDALE",22,23,0,6,45,39,2019,"ILLINOIS"
"538","SOUTHERN METHODIST UNIVERSITY",103,50,0,22,153,131,2019,"TEXAS"
"539","SOUTHERN UNIVERSITY",66,69,0,84,135,51,2019,"LOUISIANA"
"540","SOUTHWESTERN LAW SCHOOL",74,66,0,40,140,100,2019,"CALIFORNIA"
"541","ST. JOHN'S UNIVERSITY",93,59,0,22,152,130,2019,"NEW YORK"
"542","ST. MARY'S UNIVERSITY",65,37,0,25,102,77,2019,"TEXAS"
"543","ST. THOMAS UNIVERSITY (FLORIDA)",56,29,0,25,85,60,2019,"FLORIDA"
"544","ST. THOMAS, UNIVERSITY OF (MINNESOTA)",82,48,0,18,130,112,2019,"MINNESOTA"
"545","STANFORD UNIVERSITY",124,80,0,39,204,165,2019,"CALIFORNIA"
"546","STETSON UNIVERSITY",77,58,0,15,135,120,2019,"FLORIDA"
"547","SUFFOLK UNIVERSITY",97,74,0,23,171,148,2019,"MASSACHUSETTS"
"548","SYRACUSE UNIVERSITY",60,34,0,10,94,84,2019,"NEW YORK"
"549","TEMPLE UNIVERSITY",114,78,0,35,192,157,2019,"PENNSYLVANIA"
"550","TENNESSEE, UNIVERSITY OF",55,38,0,10,93,83,2019,"TENNESSEE"
"551","TEXAS A&M UNIVERSITY",59,44,0,19,103,84,2019,"TEXAS"
"552","TEXAS AT AUSTIN, UNIVERSITY OF",201,91,0,31,292,261,2019,"TEXAS"
"553","TEXAS SOUTHERN UNIVERSITY THURGOOD MARSHALL SCHOOL OF LAW",38,57,0,77,95,18,2019,NA
"554","TEXAS TECH UNIVERSITY",36,22,0,8,58,50,2019,"TEXAS"
"555","TOLEDO, UNIVERSITY OF",26,17,0,5,43,38,2019,"OHIO"
"556","TOURO UNIVERSITY",49,34,0,9,83,74,2019,"NEW YORK"
"557","TULANE UNIVERSITY",113,49,0,16,162,146,2019,"LOUISIANA"
"558","TULSA, UNIVERSITY OF",28,25,0,7,53,46,2019,"OKLAHOMA"
"559","UNIVERSITY OF BUFFALO-SUNY",66,50,0,9,116,107,2019,"NEW YORK"
"560","UNIVERSITY OF CALIFORNIA COLLEGE OF THE LAW, SAN FRANCISCO",122,97,0,41,219,178,2019,"CALIFORNIA"
"561","UNIVERSITY OF ILLINOIS CHICAGO SCHOOL OF LAW",108,75,0,35,183,148,2019,"ILLINOIS"
"562","UNIVERSITY OF MASSACHUSETTS DARTMOUTH",24,14,0,5,38,33,2019,"MASSACHUSETTS"
"563","UNIVERSITY OF NEVADA - LAS VEGAS",52,50,0,19,102,83,2019,"NEVADA"
"564","UTAH, UNIVERSITY OF",57,40,0,12,97,85,2019,"UTAH"
"565","VANDERBILT UNIVERSITY",88,53,0,21,141,120,2019,"TENNESSEE"
"566","VERMONT LAW SCHOOL",50,59,0,4,109,105,2019,"VERMONT"
"567","VILLANOVA UNIVERSITY",61,49,0,14,110,96,2019,"PENNSYLVANIA"
"568","VIRGINIA, UNIVERSITY OF",159,79,0,24,238,214,2019,"VIRGINIA"
"569","WAKE FOREST UNIVERSITY",66,42,0,16,108,92,2019,"NORTH CAROLINA"
"570","WASHBURN UNIVERSITY",33,32,0,7,65,58,2019,"KANSAS"
"571","WASHINGTON AND LEE UNIVERSITY",62,28,0,12,90,78,2019,"VIRGINIA"
"572","WASHINGTON UNIVERSITY",100,69,0,22,169,147,2019,"MISSOURI"
"573","WASHINGTON, UNIVERSITY OF",105,62,0,25,167,142,2019,"WASHINGTON"
"574","WAYNE STATE UNIVERSITY",52,40,0,10,92,82,2019,"MICHIGAN"
"575","WEST VIRGINIA UNIVERSITY",33,29,0,4,62,58,2019,"WEST VIRGINIA"
"576","COOLEY LAW SCHOOL",140,86,0,35,226,191,2019,NA
"577","WESTERN NEW ENGLAND UNIVERSITY",32,26,0,4,58,54,2019,"MASSACHUSETTS"
"578","WESTERN STATE COLLEGE OF LAW",30,27,0,18,57,39,2019,"CALIFORNIA"
"579","WIDENER UNIVERSITY-DELAWARE",42,38,0,9,80,71,2019,"DELAWARE"
"580","WIDENER-COMMONWEALTH",37,21,0,3,58,55,2019,"PENNSYLVANIA"
"581","WILLAMETTE UNIVERSITY",29,21,0,6,50,44,2019,"OREGON"
"582","WILLIAM AND MARY LAW SCHOOL",103,53,0,13,156,143,2019,"VIRGINIA"
"583","WISCONSIN, UNIVERSITY OF",64,57,0,22,121,99,2019,"WISCONSIN"
"584","WYOMING, UNIVERSITY OF",20,15,0,6,35,29,2019,"WYOMING"
"585","YALE UNIVERSITY",155,94,0,35,249,214,2019,"CONNECTICUT"
"586","AKRON, UNIVERSITY OF",40,28,0,5,68,63,2020,"OHIO"
"587","ALABAMA, UNIVERSITY OF",69,34,0,16,103,87,2020,"ALABAMA"
"588","ALBANY LAW SCHOOL",48,39,0,11,87,76,2020,"NEW YORK"
"589","AMERICAN UNIVERSITY",156,140,0,60,296,236,2020,"DISTRICT OF COLUMBIA"
"590","APPALACHIAN SCHOOL OF LAW",17,9,0,2,26,24,2020,"VIRGINIA"
"591","ARIZONA STATE UNIVERSITY",126,63,0,42,189,147,2020,"ARIZONA"
"592","ARIZONA, UNIVERSITY OF",91,72,0,28,163,135,2020,"ARIZONA"
"593","ARKANSAS, FAYETTEVILLE, UNIVERSITY OF",41,28,0,8,69,61,2020,"ARKANSAS"
"594","ARKANSAS, LITTLE ROCK, UNIVERSITY OF",52,40,0,12,92,80,2020,"ARKANSAS"
"595","ATLANTA'S JOHN MARSHALL LAW SCHOOL",17,18,0,8,35,27,2020,"GEORGIA"
"596","AVE MARIA SCHOOL OF LAW",23,15,0,2,38,36,2020,"FLORIDA"
"597","BALTIMORE, UNIVERSITY OF",80,59,0,24,139,115,2020,"MARYLAND"
"598","BARRY UNIVERSITY",42,35,0,23,79,56,2020,"FLORIDA"
"599","BAYLOR UNIVERSITY",91,45,0,7,136,129,2020,"TEXAS"
"600","BELMONT UNIVERSITY",33,16,0,6,49,43,2020,"TENNESSEE"
"601","BOSTON COLLEGE",80,74,0,28,154,126,2020,"MASSACHUSETTS"
"602","BOSTON UNIVERSITY",128,93,0,20,221,201,2020,"MASSACHUSETTS"
"603","BRIGHAM YOUNG UNIVERSITY",58,29,0,7,87,80,2020,"UTAH"
"604","BROOKLYN LAW SCHOOL",118,81,0,30,199,169,2020,"NEW YORK"
"605","CALIFORNIA WESTERN SCHOOL OF LAW",59,54,0,24,113,89,2020,"CALIFORNIA"
"606","CALIFORNIA-BERKELEY, UNIVERSITY OF",183,119,0,64,302,238,2020,"CALIFORNIA"
"607","CALIFORNIA-DAVIS, UNIVERSITY OF",66,52,0,39,118,79,2020,"CALIFORNIA"
"608","CALIFORNIA-IRVINE, UNIVERSITY OF",79,79,1,40,159,119,2020,"CALIFORNIA"
"609","CALIFORNIA-LOS ANGELES, UNIVERSITY OF",116,85,0,44,201,157,2020,"CALIFORNIA"
"610","CAMPBELL UNIVERSITY",63,42,0,21,105,84,2020,"NORTH CAROLINA"
"611","CAPITAL UNIVERSITY",53,24,0,7,77,70,2020,"OHIO"
"612","CARDOZO SCHOOL OF LAW",200,148,0,30,348,318,2020,"NEW YORK"
"613","CASE WESTERN RESERVE UNIVERSITY",76,27,0,8,103,95,2020,"OHIO"
"614","CATHOLIC UNIVERSITY OF AMERICA",59,31,0,8,90,82,2020,"DISTRICT OF COLUMBIA"
"615","CHAPMAN UNIVERSITY",66,52,0,17,118,101,2020,"CALIFORNIA"
"616","CHARLESTON SCHOOL OF LAW",48,34,0,5,82,77,2020,"SOUTH CAROLINA"
"617","CHICAGO, UNIVERSITY OF",133,54,0,33,187,154,2020,"ILLINOIS"
"618","CHICAGO-KENT COLLEGE OF LAW-IIT",116,49,0,31,165,134,2020,"ILLINOIS"
"619","CINCINNATI, UNIVERSITY OF",54,39,0,13,93,80,2020,"OHIO"
"620","CITY UNIVERSITY OF NEW YORK",35,64,0,41,99,58,2020,"NEW YORK"
"621","CLEVELAND STATE UNIVERSITY",55,39,0,19,94,75,2020,"OHIO"
"622","COLORADO, UNIVERSITY OF",62,44,0,21,106,85,2020,"COLORADO"
"623","COLUMBIA UNIVERSITY",252,163,0,56,415,359,2020,"NEW YORK"
"624","CONNECTICUT, UNIVERSITY OF",86,43,0,16,129,113,2020,"CONNECTICUT"
"625","CORNELL UNIVERSITY",133,63,1,32,197,165,2020,"NEW YORK"
"626","CREIGHTON UNIVERSITY",40,17,0,4,57,53,2020,"NEBRASKA"
"627","DAYTON, UNIVERSITY OF",33,32,0,8,65,57,2020,"OHIO"
"628","DENVER, UNIVERSITY OF",86,68,0,25,154,129,2020,"COLORADO"
"629","DEPAUL UNIVERSITY",74,72,1,32,147,115,2020,"ILLINOIS"
"630","DETROIT MERCY, UNIVERSITY OF",49,45,0,16,94,78,2020,"MICHIGAN"
"631","DISTRICT OF COLUMBIA",24,37,0,30,61,31,2020,"DISTRICT OF COLUMBIA"
"632","DRAKE UNIVERSITY",43,34,0,8,77,69,2020,"IOWA"
"633","DREXEL UNIVERSITY",71,63,0,33,134,101,2020,"PENNSYLVANIA"
"634","DUKE UNIVERSITY",122,75,0,28,197,169,2020,"NORTH CAROLINA"
"635","DUQUESNE UNIVERSITY",60,40,0,12,100,88,2020,"PENNSYLVANIA"
"636","ELON UNIVERSITY",32,36,0,7,68,61,2020,"NORTH CAROLINA"
"637","EMORY UNIVERSITY",117,116,0,36,233,197,2020,"GEORGIA"
"638","FAULKNER UNIVERSITY",20,11,0,5,31,26,2020,"ALABAMA"
"639","FLORIDA A&M UNIVERSITY",29,32,0,42,61,19,2020,"FLORIDA"
"640","FLORIDA INTERNATIONAL UNIVERSITY",48,36,0,43,84,41,2020,"FLORIDA"
"641","FLORIDA STATE UNIVERSITY",62,37,0,12,99,87,2020,"FLORIDA"
"642","FLORIDA, UNIVERSITY OF",141,82,0,37,223,186,2020,"FLORIDA"
"643","FORDHAM UNIVERSITY",221,163,0,58,384,326,2020,"NEW YORK"
"644","GEORGE MASON UNIVERSITY",158,75,0,25,233,208,2020,"VIRGINIA"
"645","GEORGE WASHINGTON UNIVERSITY",339,160,0,64,499,435,2020,"DISTRICT OF COLUMBIA"
"646","GEORGETOWN UNIVERSITY",534,295,2,103,831,728,2020,"DISTRICT OF COLUMBIA"
"647","GEORGIA STATE UNIVERSITY",70,66,0,22,136,114,2020,"GEORGIA"
"648","GEORGIA, UNIVERSITY OF",61,45,0,14,106,92,2020,"GEORGIA"
"649","GOLDEN GATE UNIVERSITY",72,64,0,28,136,108,2020,"CALIFORNIA"
"650","GONZAGA UNIVERSITY",44,35,0,11,79,68,2020,"WASHINGTON"
"651","HARVARD UNIVERSITY",237,122,1,64,360,296,2020,"MASSACHUSETTS"
"652","HAWAII, UNIVERSITY OF",67,54,0,54,121,67,2020,"HAWAII"
"653","HOFSTRA UNIVERSITY",103,70,0,12,173,161,2020,"NEW YORK"
"654","HOUSTON, UNIVERSITY OF",143,79,0,37,222,185,2020,"TEXAS"
"655","HOWARD UNIVERSITY",45,42,0,70,87,17,2020,"DISTRICT OF COLUMBIA"
"656","IDAHO, UNIVERSITY OF",37,30,0,6,67,61,2020,"IDAHO"
"657","ILLINOIS, UNIVERSITY OF",79,52,0,19,131,112,2020,"ILLINOIS"
"658","INDIANA UNIVERSITY - BLOOMINGTON",72,44,0,11,116,105,2020,"INDIANA"
"659","INDIANA UNIVERSITY - INDIANAPOLIS",75,70,0,23,145,122,2020,"INDIANA"
"660","INTER AMERICAN UNIVERSITY OF PUERTO RICO",62,28,0,87,90,3,2020,"PUERTO RICO"
"661","IOWA, UNIVERSITY OF",51,33,0,9,84,75,2020,"IOWA"
"662","KANSAS, UNIVERSITY OF",42,29,0,6,71,65,2020,"KANSAS"
"663","KENTUCKY, UNIVERSITY OF",37,33,0,8,70,62,2020,"KENTUCKY"
"664","LEWIS AND CLARK COLLEGE",69,54,0,17,123,106,2020,"OREGON"
"665","LIBERTY UNIVERSITY",24,8,0,8,32,24,2020,"VIRGINIA"
"666","LINCOLN MEMORIAL",22,17,0,4,39,35,2020,"DISTRICT OF COLUMBIA"
"667","LOUISIANA STATE UNIVERSITY",60,28,0,9,88,79,2020,"LOUISIANA"
"668","LOUISVILLE, UNIVERSITY OF",36,24,0,7,60,53,2020,"KENTUCKY"
"669","LOYOLA MARYMOUNT UNIVERSITY-LOS ANGELES",112,83,4,38,199,161,2020,"CALIFORNIA"
"670","LOYOLA UNIVERSITY-CHICAGO",131,119,0,36,250,214,2020,"ILLINOIS"
"671","LOYOLA UNIVERSITY-NEW ORLEANS",53,32,0,17,85,68,2020,"LOUISIANA"
"672","MAINE, UNIVERSITY OF",41,29,0,2,70,68,2020,"MAINE"
"673","MARQUETTE UNIVERSITY",69,47,0,11,116,105,2020,"WISCONSIN"
"674","MARYLAND, UNIVERSITY OF",104,67,0,28,171,143,2020,"MARYLAND"
"675","MCGEORGE SCHOOL OF LAW",64,44,0,20,108,88,2020,"CALIFORNIA"
"676","MEMPHIS, UNIVERSITY OF",40,24,0,8,64,56,2020,"TENNESSEE"
"677","MERCER UNIVERSITY",45,24,0,6,69,63,2020,"GEORGIA"
"678","MIAMI, UNIVERSITY OF",221,117,0,80,338,258,2020,"FLORIDA"
"679","MICHIGAN STATE UNIVERSITY",63,46,0,13,109,96,2020,"MICHIGAN"
"680","MICHIGAN, UNIVERSITY OF",123,59,0,20,182,162,2020,"MICHIGAN"
"681","MINNESOTA, UNIVERSITY OF",134,84,0,21,218,197,2020,"MINNESOTA"
"682","MISSISSIPPI COLLEGE",32,20,0,11,52,41,2020,"MISSISSIPPI"
"683","MISSISSIPPI, UNIVERSITY OF",38,27,0,8,65,57,2020,"MISSISSIPPI"
"684","MISSOURI, UNIVERSITY OF",30,19,0,6,49,43,2020,"MISSOURI"
"685","MISSOURI-KANSAS CITY, UNIVERSITY OF",68,46,0,9,114,105,2020,"MISSOURI"
"686","MITCHELL | HAMLINE",122,107,0,22,229,207,2020,NA
"687","MONTANA, UNIVERSITY OF",15,19,0,3,34,31,2020,"MONTANA"
"688","NEBRASKA, UNIVERSITY OF",49,26,0,4,75,71,2020,"NEBRASKA"
"689","NEW ENGLAND LAW | BOSTON",67,45,0,7,112,105,2020,"MASSACHUSETTS"
"690","NEW HAMPSHIRE, UNIVERSITY OF",61,40,14,2,115,113,2020,"NEW HAMPSHIRE"
"691","NEW MEXICO, UNIVERSITY OF",50,48,0,36,98,62,2020,"NEW MEXICO"
"692","NEW YORK LAW SCHOOL",123,81,0,30,204,174,2020,"NEW YORK"
"693","NEW YORK UNIVERSITY",258,135,0,65,393,328,2020,"NEW YORK"
"694","NORTH CAROLINA CENTRAL UNIVERSITY",26,42,0,43,68,25,2020,"NORTH CAROLINA"
"695","NORTH CAROLINA, UNIVERSITY OF",74,56,0,19,130,111,2020,"NORTH CAROLINA"
"696","NORTH DAKOTA, UNIVERSITY OF",13,15,0,2,28,26,2020,"NORTH DAKOTA"
"697","NORTHEASTERN UNIVERSITY SCHOOL OF LAW",55,58,0,21,113,92,2020,NA
"698","NORTHERN ILLINOIS UNIVERSITY",30,13,0,6,43,37,2020,"ILLINOIS"
"699","NORTHERN KENTUCKY UNIVERSITY",41,21,0,8,62,54,2020,"KENTUCKY"
"700","NORTHWESTERN UNIVERSITY",146,89,0,35,235,200,2020,"ILLINOIS"
"701","NOTRE DAME, UNIVERSITY OF",92,43,0,13,135,122,2020,"INDIANA"
"702","NOVA SOUTHEASTERN UNIVERSITY",42,38,0,21,80,59,2020,"FLORIDA"
"703","OHIO NORTHERN UNIVERSITY",15,13,0,4,28,24,2020,"OHIO"
"704","OHIO STATE UNIVERSITY",73,45,0,17,118,101,2020,"OHIO"
"705","OKLAHOMA CITY UNIVERSITY",55,31,0,16,86,70,2020,"OKLAHOMA"
"706","OKLAHOMA, UNIVERSITY OF",44,30,0,10,74,64,2020,"OKLAHOMA"
"707","OREGON, UNIVERSITY OF",37,51,0,14,88,74,2020,"OREGON"
"708","PACE UNIVERSITY",60,56,0,14,116,102,2020,"NEW YORK"
"709","PENNSYLVANIA STATE - DICKINSON LAW",30,29,0,12,59,47,2020,"PENNSYLVANIA"
"710","PENNSYLVANIA STATE - PENN STATE LAW",40,24,0,9,64,55,2020,"PENNSYLVANIA"
"711","PENNSYLVANIA, UNIVERSITY OF",175,95,0,55,270,215,2020,"PENNSYLVANIA"
"712","PEPPERDINE UNIVERSITY",96,37,0,27,133,106,2020,"CALIFORNIA"
"713","PITTSBURGH, UNIVERSITY OF",97,51,0,16,148,132,2020,"PENNSYLVANIA"
"714","PONTIFICAL CATHOLIC UNIVERSITY OF P.R.",39,19,0,58,58,0,2020,"PUERTO RICO"
"715","PUERTO RICO, UNIVERSITY OF",67,42,0,108,109,1,2020,"PUERTO RICO"
"716","QUINNIPIAC UNIVERSITY",66,39,0,12,105,93,2020,"CONNECTICUT"
"717","REGENT UNIVERSITY",39,7,0,7,46,39,2020,"VIRGINIA"
"718","RICHMOND, UNIVERSITY OF",70,51,0,13,121,108,2020,"VIRGINIA"
"719","ROGER WILLIAMS UNIVERSITY",46,42,0,11,88,77,2020,"RHODE ISLAND"
"720","RUTGERS UNIVERSITY",126,88,0,40,214,174,2020,"NEW JERSEY"
"721","SAINT LOUIS UNIVERSITY",48,58,0,7,106,99,2020,"MISSOURI"
"722","SAMFORD UNIVERSITY",34,18,0,7,52,45,2020,"ALABAMA"
"723","SAN DIEGO, UNIVERSITY OF",105,55,0,17,160,143,2020,"CALIFORNIA"
"724","SAN FRANCISCO, UNIVERSITY OF",38,38,0,17,76,59,2020,"CALIFORNIA"
"725","SANTA CLARA UNIVERSITY",76,71,0,32,147,115,2020,"CALIFORNIA"
"726","SEATTLE UNIVERSITY",76,79,0,28,155,127,2020,"WASHINGTON"
"727","SETON HALL UNIVERSITY",75,53,0,13,128,115,2020,"NEW JERSEY"
"728","SOUTH CAROLINA, UNIVERSITY OF",70,42,0,12,112,100,2020,"SOUTH CAROLINA"
"729","SOUTH DAKOTA, UNIVERSITY OF",18,16,0,5,34,29,2020,"SOUTH DAKOTA"
"730","SOUTH TEXAS COLLEGE OF LAW HOUSTON",81,46,0,23,127,104,2020,"TEXAS"
"731","SOUTHERN CALIFORNIA, UNIVERSITY OF",108,66,0,28,174,146,2020,"CALIFORNIA"
"732","SOUTHERN ILLINOIS UNIVERSITY-CARBONDALE",24,24,0,8,48,40,2020,"ILLINOIS"
"733","SOUTHERN METHODIST UNIVERSITY",100,51,0,20,151,131,2020,"TEXAS"
"734","SOUTHERN UNIVERSITY",55,54,0,78,109,31,2020,"LOUISIANA"
"735","SOUTHWESTERN LAW SCHOOL",77,72,0,40,149,109,2020,"CALIFORNIA"
"736","ST. JOHN'S UNIVERSITY",109,76,0,27,185,158,2020,"NEW YORK"
"737","ST. MARY'S UNIVERSITY",61,40,0,24,101,77,2020,"TEXAS"
"738","ST. THOMAS UNIVERSITY (FLORIDA)",53,35,0,26,88,62,2020,"FLORIDA"
"739","ST. THOMAS, UNIVERSITY OF (MINNESOTA)",91,56,0,24,147,123,2020,"MINNESOTA"
"740","STANFORD UNIVERSITY",108,82,0,34,190,156,2020,"CALIFORNIA"
"741","STETSON UNIVERSITY",70,63,0,19,133,114,2020,"FLORIDA"
"742","SUFFOLK UNIVERSITY",102,77,0,27,179,152,2020,"MASSACHUSETTS"
"743","SYRACUSE UNIVERSITY",59,41,0,13,100,87,2020,"NEW YORK"
"744","TEMPLE UNIVERSITY",107,82,0,36,189,153,2020,"PENNSYLVANIA"
"745","TENNESSEE, UNIVERSITY OF",58,37,0,10,95,85,2020,"TENNESSEE"
"746","TEXAS A&M UNIVERSITY",60,49,0,23,109,86,2020,"TEXAS"
"747","TEXAS AT AUSTIN, UNIVERSITY OF",219,85,0,36,304,268,2020,"TEXAS"
"748","TEXAS SOUTHERN UNIVERSITY THURGOOD MARSHALL SCHOOL OF LAW",33,59,0,78,92,14,2020,NA
"749","TEXAS TECH UNIVERSITY",36,23,0,9,59,50,2020,"TEXAS"
"750","TOLEDO, UNIVERSITY OF",24,19,0,6,43,37,2020,"OHIO"
"751","TOURO UNIVERSITY",48,32,0,9,80,71,2020,"NEW YORK"
"752","TULANE UNIVERSITY",102,46,0,19,148,129,2020,"LOUISIANA"
"753","TULSA, UNIVERSITY OF",25,24,0,6,49,43,2020,"OKLAHOMA"
"754","UNIVERSITY OF BUFFALO-SUNY",70,49,0,9,119,110,2020,"NEW YORK"
"755","UNIVERSITY OF CALIFORNIA COLLEGE OF THE LAW, SAN FRANCISCO",135,88,0,42,223,181,2020,"CALIFORNIA"
"756","UNIVERSITY OF ILLINOIS CHICAGO SCHOOL OF LAW",106,74,0,38,180,142,2020,"ILLINOIS"
"757","UNIVERSITY OF MASSACHUSETTS DARTMOUTH",28,17,0,5,45,40,2020,"MASSACHUSETTS"
"758","UNIVERSITY OF NEVADA - LAS VEGAS",56,40,0,19,96,77,2020,"NEVADA"
"759","UTAH, UNIVERSITY OF",50,45,0,13,95,82,2020,"UTAH"
"760","VANDERBILT UNIVERSITY",88,51,0,20,139,119,2020,"TENNESSEE"
"761","VERMONT LAW SCHOOL",62,67,0,5,129,124,2020,"VERMONT"
"762","VILLANOVA UNIVERSITY",63,52,0,19,115,96,2020,"PENNSYLVANIA"
"763","VIRGINIA, UNIVERSITY OF",161,73,0,23,234,211,2020,"VIRGINIA"
"764","WAKE FOREST UNIVERSITY",79,46,0,19,125,106,2020,"NORTH CAROLINA"
"765","WASHBURN UNIVERSITY",34,26,0,7,60,53,2020,"KANSAS"
"766","WASHINGTON AND LEE UNIVERSITY",59,30,0,9,89,80,2020,"VIRGINIA"
"767","WASHINGTON UNIVERSITY",110,73,0,28,183,155,2020,"MISSOURI"
"768","WASHINGTON, UNIVERSITY OF",87,54,0,25,141,116,2020,"WASHINGTON"
"769","WAYNE STATE UNIVERSITY",58,45,0,12,103,91,2020,"MICHIGAN"
"770","WEST VIRGINIA UNIVERSITY",37,27,0,4,64,60,2020,"WEST VIRGINIA"
"771","COOLEY LAW SCHOOL",127,82,0,34,209,175,2020,NA
"772","WESTERN NEW ENGLAND UNIVERSITY",36,28,0,6,64,58,2020,"MASSACHUSETTS"
"773","WESTERN STATE COLLEGE OF LAW",26,20,0,12,46,34,2020,"CALIFORNIA"
"774","WIDENER UNIVERSITY-DELAWARE",43,40,0,6,83,77,2020,"DELAWARE"
"775","WIDENER-COMMONWEALTH",40,25,0,2,65,63,2020,"PENNSYLVANIA"
"776","WILLAMETTE UNIVERSITY",32,22,0,7,54,47,2020,"OREGON"
"777","WILLIAM AND MARY LAW SCHOOL",106,55,0,19,161,142,2020,"VIRGINIA"
"778","WISCONSIN, UNIVERSITY OF",72,56,0,21,128,107,2020,"WISCONSIN"
"779","WYOMING, UNIVERSITY OF",24,13,0,6,37,31,2020,"WYOMING"
"780","YALE UNIVERSITY",160,88,1,33,249,216,2020,"CONNECTICUT"
"781","AKRON, UNIVERSITY OF",39,24,0,3,63,60,2021,"OHIO"
"782","ALABAMA, UNIVERSITY OF",66,29,0,12,95,83,2021,"ALABAMA"
"783","ALBANY LAW SCHOOL",48,35,0,12,83,71,2021,"NEW YORK"
"784","AMERICAN UNIVERSITY",152,138,0,64,290,226,2021,"DISTRICT OF COLUMBIA"
"785","APPALACHIAN SCHOOL OF LAW",17,10,0,3,27,24,2021,"VIRGINIA"
"786","ARIZONA STATE UNIVERSITY",141,68,0,39,209,170,2021,"ARIZONA"
"787","ARIZONA, UNIVERSITY OF",76,73,0,33,149,116,2021,"ARIZONA"
"788","ARKANSAS, FAYETTEVILLE, UNIVERSITY OF",36,28,0,9,64,55,2021,"ARKANSAS"
"789","ARKANSAS, LITTLE ROCK, UNIVERSITY OF",46,41,0,13,87,74,2021,"ARKANSAS"
"790","ATLANTA'S JOHN MARSHALL LAW SCHOOL",15,19,0,9,34,25,2021,"GEORGIA"
"791","AVE MARIA SCHOOL OF LAW",21,15,0,2,36,34,2021,"FLORIDA"
"792","BALTIMORE, UNIVERSITY OF",84,60,0,27,144,117,2021,"MARYLAND"
"793","BARRY UNIVERSITY",40,28,0,16,68,52,2021,"FLORIDA"
"794","BAYLOR UNIVERSITY",109,49,0,15,158,143,2021,"TEXAS"
"795","BELMONT UNIVERSITY",29,13,0,6,42,36,2021,"TENNESSEE"
"796","BOSTON COLLEGE",75,67,0,26,142,116,2021,"MASSACHUSETTS"
"797","BOSTON UNIVERSITY",120,88,2,23,210,187,2021,"MASSACHUSETTS"
"798","BRIGHAM YOUNG UNIVERSITY",55,32,0,9,87,78,2021,"UTAH"
"799","BROOKLYN LAW SCHOOL",116,79,0,36,195,159,2021,"NEW YORK"
"800","CALIFORNIA WESTERN SCHOOL OF LAW",58,54,0,25,112,87,2021,"CALIFORNIA"
"801","CALIFORNIA-BERKELEY, UNIVERSITY OF",153,131,0,61,284,223,2021,"CALIFORNIA"
"802","CALIFORNIA-DAVIS, UNIVERSITY OF",62,53,0,40,115,75,2021,"CALIFORNIA"
"803","CALIFORNIA-IRVINE, UNIVERSITY OF",73,69,1,41,143,102,2021,"CALIFORNIA"
"804","CALIFORNIA-LOS ANGELES, UNIVERSITY OF",113,84,0,45,197,152,2021,"CALIFORNIA"
"805","CAMPBELL UNIVERSITY",60,46,0,20,106,86,2021,"NORTH CAROLINA"
"806","CAPITAL UNIVERSITY",52,26,0,10,78,68,2021,"OHIO"
"807","CARDOZO SCHOOL OF LAW",166,131,0,30,297,267,2021,"NEW YORK"
"808","CASE WESTERN RESERVE UNIVERSITY",72,30,0,9,102,93,2021,"OHIO"
"809","CATHOLIC UNIVERSITY OF AMERICA",58,28,0,8,86,78,2021,"DISTRICT OF COLUMBIA"
"810","CHAPMAN UNIVERSITY",65,47,0,17,112,95,2021,"CALIFORNIA"
"811","CHARLESTON SCHOOL OF LAW",41,34,0,8,75,67,2021,"SOUTH CAROLINA"
"812","CHICAGO, UNIVERSITY OF",132,51,0,35,183,148,2021,"ILLINOIS"
"813","CHICAGO-KENT COLLEGE OF LAW-IIT",96,44,0,26,140,114,2021,"ILLINOIS"
"814","CINCINNATI, UNIVERSITY OF",46,39,0,12,85,73,2021,"OHIO"
"815","CITY UNIVERSITY OF NEW YORK",31,65,0,42,96,54,2021,"NEW YORK"
"816","CLEVELAND STATE UNIVERSITY",52,34,0,13,86,73,2021,"OHIO"
"817","COLORADO, UNIVERSITY OF",62,47,0,18,109,91,2021,"COLORADO"
"818","COLUMBIA UNIVERSITY",215,152,0,60,367,307,2021,"NEW YORK"
"819","CONNECTICUT, UNIVERSITY OF",88,52,0,15,140,125,2021,"CONNECTICUT"
"820","CORNELL UNIVERSITY",113,67,1,32,181,149,2021,"NEW YORK"
"821","CREIGHTON UNIVERSITY",34,19,0,6,53,47,2021,"NEBRASKA"
"822","DAYTON, UNIVERSITY OF",50,43,0,16,93,77,2021,"OHIO"
"823","DENVER, UNIVERSITY OF",83,69,0,22,152,130,2021,"COLORADO"
"824","DEPAUL UNIVERSITY",64,64,4,29,132,103,2021,"ILLINOIS"
"825","DETROIT MERCY, UNIVERSITY OF",42,41,0,12,83,71,2021,"MICHIGAN"
"826","DISTRICT OF COLUMBIA",17,30,0,25,47,22,2021,"DISTRICT OF COLUMBIA"
"827","DRAKE UNIVERSITY",36,38,0,8,74,66,2021,"IOWA"
"828","DREXEL UNIVERSITY",70,64,1,32,135,103,2021,"PENNSYLVANIA"
"829","DUKE UNIVERSITY",111,72,0,26,183,157,2021,"NORTH CAROLINA"
"830","DUQUESNE UNIVERSITY",51,37,0,14,88,74,2021,"PENNSYLVANIA"
"831","ELON UNIVERSITY",27,32,0,7,59,52,2021,"NORTH CAROLINA"
"832","EMORY UNIVERSITY",103,100,0,37,203,166,2021,"GEORGIA"
"833","FAULKNER UNIVERSITY",21,10,0,4,31,27,2021,"ALABAMA"
"834","FLORIDA A&M UNIVERSITY",30,26,0,41,56,15,2021,"FLORIDA"
"835","FLORIDA INTERNATIONAL UNIVERSITY",51,37,0,40,88,48,2021,"FLORIDA"
"836","FLORIDA STATE UNIVERSITY",75,38,0,20,113,93,2021,"FLORIDA"
"837","FLORIDA, UNIVERSITY OF",143,107,0,49,250,201,2021,"FLORIDA"
"838","FORDHAM UNIVERSITY",226,153,0,59,379,320,2021,"NEW YORK"
"839","GEORGE MASON UNIVERSITY",157,78,0,33,235,202,2021,"VIRGINIA"
"840","GEORGE WASHINGTON UNIVERSITY",297,153,0,60,450,390,2021,"DISTRICT OF COLUMBIA"
"841","GEORGETOWN UNIVERSITY",504,308,0,116,812,696,2021,"DISTRICT OF COLUMBIA"
"842","GEORGIA STATE UNIVERSITY",60,70,0,25,130,105,2021,"GEORGIA"
"843","GEORGIA, UNIVERSITY OF",65,41,0,14,106,92,2021,"GEORGIA"
"844","GOLDEN GATE UNIVERSITY",64,60,0,29,124,95,2021,"CALIFORNIA"
"845","GONZAGA UNIVERSITY",32,33,0,12,65,53,2021,"WASHINGTON"
"846","HARVARD UNIVERSITY",199,140,0,62,339,277,2021,"MASSACHUSETTS"
"847","HAWAII, UNIVERSITY OF",68,51,0,53,119,66,2021,"HAWAII"
"848","HOFSTRA UNIVERSITY",80,48,0,12,128,116,2021,"NEW YORK"
"849","HOUSTON, UNIVERSITY OF",138,79,0,39,217,178,2021,"TEXAS"
"850","HOWARD UNIVERSITY",47,43,0,74,90,16,2021,"DISTRICT OF COLUMBIA"
"851","IDAHO, UNIVERSITY OF",47,42,0,0,89,89,2021,"IDAHO"
"852","ILLINOIS, UNIVERSITY OF",64,53,0,22,117,95,2021,"ILLINOIS"
"853","INDIANA UNIVERSITY - BLOOMINGTON",68,46,0,14,114,100,2021,"INDIANA"
"854","INDIANA UNIVERSITY - INDIANAPOLIS",77,68,0,20,145,125,2021,"INDIANA"
"855","INTER AMERICAN UNIVERSITY OF PUERTO RICO",62,36,0,96,98,2,2021,"PUERTO RICO"
"856","IOWA, UNIVERSITY OF",48,37,0,14,85,71,2021,"IOWA"
"857","KANSAS, UNIVERSITY OF",51,28,0,6,79,73,2021,"KANSAS"
"858","KENTUCKY, UNIVERSITY OF",32,30,0,6,62,56,2021,"KENTUCKY"
"859","LEWIS AND CLARK COLLEGE",80,56,0,20,136,116,2021,"OREGON"
"860","LIBERTY UNIVERSITY",23,13,0,9,36,27,2021,"VIRGINIA"
"861","LINCOLN MEMORIAL",23,22,0,6,45,39,2021,"DISTRICT OF COLUMBIA"
"862","LOUISIANA STATE UNIVERSITY",50,30,0,10,80,70,2021,"LOUISIANA"
"863","LOUISVILLE, UNIVERSITY OF",39,30,0,16,69,53,2021,"KENTUCKY"
"864","LOYOLA MARYMOUNT UNIVERSITY-LOS ANGELES",99,72,0,31,171,140,2021,"CALIFORNIA"
"865","LOYOLA UNIVERSITY-CHICAGO",136,169,0,74,305,231,2021,"ILLINOIS"
"866","LOYOLA UNIVERSITY-NEW ORLEANS",52,31,0,20,83,63,2021,"LOUISIANA"
"867","MAINE, UNIVERSITY OF",43,30,0,4,73,69,2021,"MAINE"
"868","MARQUETTE UNIVERSITY",60,48,0,10,108,98,2021,"WISCONSIN"
"869","MARYLAND, UNIVERSITY OF",95,68,0,29,163,134,2021,"MARYLAND"
"870","MCGEORGE SCHOOL OF LAW",56,41,0,23,97,74,2021,"CALIFORNIA"
"871","MEMPHIS, UNIVERSITY OF",36,23,0,11,59,48,2021,"TENNESSEE"
"872","MERCER UNIVERSITY",46,25,0,8,71,63,2021,"GEORGIA"
"873","MIAMI, UNIVERSITY OF",217,120,0,78,337,259,2021,"FLORIDA"
"874","MICHIGAN STATE UNIVERSITY",62,45,0,16,107,91,2021,"MICHIGAN"
"875","MICHIGAN, UNIVERSITY OF",104,67,0,28,171,143,2021,"MICHIGAN"
"876","MINNESOTA, UNIVERSITY OF",167,105,0,42,272,230,2021,"MINNESOTA"
"877","MISSISSIPPI COLLEGE",24,25,0,17,49,32,2021,"MISSISSIPPI"
"878","MISSISSIPPI, UNIVERSITY OF",38,24,0,7,62,55,2021,"MISSISSIPPI"
"879","MISSOURI, UNIVERSITY OF",27,19,0,8,46,38,2021,"MISSOURI"
"880","MISSOURI-KANSAS CITY, UNIVERSITY OF",69,49,0,11,118,107,2021,"MISSOURI"
"881","MITCHELL | HAMLINE",88,90,1,23,179,156,2021,NA
"882","MONTANA, UNIVERSITY OF",14,20,0,3,34,31,2021,"MONTANA"
"883","NEBRASKA, UNIVERSITY OF",48,29,0,5,77,72,2021,"NEBRASKA"
"884","NEW ENGLAND LAW | BOSTON",72,54,0,9,126,117,2021,"MASSACHUSETTS"
"885","NEW HAMPSHIRE, UNIVERSITY OF",53,32,23,0,108,108,2021,"NEW HAMPSHIRE"
"886","NEW MEXICO, UNIVERSITY OF",45,51,0,38,96,58,2021,"NEW MEXICO"
"887","NEW YORK LAW SCHOOL",119,92,0,39,211,172,2021,"NEW YORK"
"888","NEW YORK UNIVERSITY",248,145,0,66,393,327,2021,"NEW YORK"
"889","NORTH CAROLINA CENTRAL UNIVERSITY",28,43,0,45,71,26,2021,"NORTH CAROLINA"
"890","NORTH CAROLINA, UNIVERSITY OF",69,55,0,13,124,111,2021,"NORTH CAROLINA"
"891","NORTH DAKOTA, UNIVERSITY OF",18,14,0,2,32,30,2021,"NORTH DAKOTA"
"892","NORTHEASTERN UNIVERSITY SCHOOL OF LAW",60,58,2,28,120,92,2021,NA
"893","NORTHERN ILLINOIS UNIVERSITY",26,19,0,11,45,34,2021,"ILLINOIS"
"894","NORTHERN KENTUCKY UNIVERSITY",40,22,0,8,62,54,2021,"KENTUCKY"
"895","NORTHWESTERN UNIVERSITY",137,84,0,33,221,188,2021,"ILLINOIS"
"896","NOTRE DAME, UNIVERSITY OF",76,37,0,14,113,99,2021,"INDIANA"
"897","NOVA SOUTHEASTERN UNIVERSITY",36,39,0,27,75,48,2021,"FLORIDA"
"898","OHIO NORTHERN UNIVERSITY",17,8,0,1,25,24,2021,"OHIO"
"899","OHIO STATE UNIVERSITY",82,54,2,19,138,119,2021,"OHIO"
"900","OKLAHOMA CITY UNIVERSITY",45,36,0,15,81,66,2021,"OKLAHOMA"
"901","OKLAHOMA, UNIVERSITY OF",43,28,0,11,71,60,2021,"OKLAHOMA"
"902","OREGON, UNIVERSITY OF",33,51,0,15,84,69,2021,"OREGON"
"903","PACE UNIVERSITY",78,53,1,17,132,115,2021,"NEW YORK"
"904","PENNSYLVANIA STATE - DICKINSON LAW",29,27,1,17,57,40,2021,"PENNSYLVANIA"
"905","PENNSYLVANIA STATE - PENN STATE LAW",47,24,0,11,71,60,2021,"PENNSYLVANIA"
"906","PENNSYLVANIA, UNIVERSITY OF",160,106,0,62,266,204,2021,"PENNSYLVANIA"
"907","PEPPERDINE UNIVERSITY",77,47,0,29,124,95,2021,"CALIFORNIA"
"908","PITTSBURGH, UNIVERSITY OF",90,51,0,18,141,123,2021,"PENNSYLVANIA"
"909","PONTIFICAL CATHOLIC UNIVERSITY OF P.R.",42,25,0,67,67,0,2021,"PUERTO RICO"
"910","PUERTO RICO, UNIVERSITY OF",62,50,0,112,112,0,2021,"PUERTO RICO"
"911","QUINNIPIAC UNIVERSITY",62,46,0,12,108,96,2021,"CONNECTICUT"
"912","REGENT UNIVERSITY",43,9,0,7,52,45,2021,"VIRGINIA"
"913","RICHMOND, UNIVERSITY OF",69,54,0,16,123,107,2021,"VIRGINIA"
"914","ROGER WILLIAMS UNIVERSITY",46,45,0,15,91,76,2021,"RHODE ISLAND"
"915","RUTGERS UNIVERSITY",86,75,0,34,161,127,2021,"NEW JERSEY"
"916","SAINT LOUIS UNIVERSITY",56,49,0,12,105,93,2021,"MISSOURI"
"917","SAMFORD UNIVERSITY",39,24,0,12,63,51,2021,"ALABAMA"
"918","SAN DIEGO, UNIVERSITY OF",103,61,0,22,164,142,2021,"CALIFORNIA"
"919","SAN FRANCISCO, UNIVERSITY OF",32,35,0,18,67,49,2021,"CALIFORNIA"
"920","SANTA CLARA UNIVERSITY",74,69,0,37,143,106,2021,"CALIFORNIA"
"921","SEATTLE UNIVERSITY",61,61,0,29,122,93,2021,"WASHINGTON"
"922","SETON HALL UNIVERSITY",76,53,0,16,129,113,2021,"NEW JERSEY"
"923","SOUTH CAROLINA, UNIVERSITY OF",70,46,0,14,116,102,2021,"SOUTH CAROLINA"
"924","SOUTH DAKOTA, UNIVERSITY OF",19,10,0,3,29,26,2021,"SOUTH DAKOTA"
"925","SOUTH TEXAS COLLEGE OF LAW HOUSTON",77,48,0,24,125,101,2021,"TEXAS"
"926","SOUTHERN CALIFORNIA, UNIVERSITY OF",82,66,0,25,148,123,2021,"CALIFORNIA"
"927","SOUTHERN ILLINOIS UNIVERSITY-CARBONDALE",18,22,0,4,40,36,2021,"ILLINOIS"
"928","SOUTHERN METHODIST UNIVERSITY",95,47,0,22,142,120,2021,"TEXAS"
"929","SOUTHERN UNIVERSITY",96,91,0,127,187,60,2021,"LOUISIANA"
"930","SOUTHWESTERN LAW SCHOOL",71,68,0,40,139,99,2021,"CALIFORNIA"
"931","ST. JOHN'S UNIVERSITY",94,70,0,26,164,138,2021,"NEW YORK"
"932","ST. MARY'S UNIVERSITY",61,32,0,22,93,71,2021,"TEXAS"
"933","ST. THOMAS UNIVERSITY (FLORIDA)",61,37,0,32,98,66,2021,"FLORIDA"
"934","ST. THOMAS, UNIVERSITY OF (MINNESOTA)",87,59,0,27,146,119,2021,"MINNESOTA"
"935","STANFORD UNIVERSITY",98,84,0,37,182,145,2021,"CALIFORNIA"
"936","STETSON UNIVERSITY",78,83,3,28,164,136,2021,"FLORIDA"
"937","SUFFOLK UNIVERSITY",89,64,0,26,153,127,2021,"MASSACHUSETTS"
"938","SYRACUSE UNIVERSITY",53,41,0,13,94,81,2021,"NEW YORK"
"939","TEMPLE UNIVERSITY",109,89,0,41,198,157,2021,"PENNSYLVANIA"
"940","TENNESSEE, UNIVERSITY OF",52,41,0,13,93,80,2021,"TENNESSEE"
"941","TEXAS A&M UNIVERSITY",59,53,0,20,112,92,2021,"TEXAS"
"942","TEXAS AT AUSTIN, UNIVERSITY OF",195,86,0,34,281,247,2021,"TEXAS"
"943","TEXAS SOUTHERN UNIVERSITY THURGOOD MARSHALL SCHOOL OF LAW",31,55,0,71,86,15,2021,NA
"944","TEXAS TECH UNIVERSITY",37,21,0,9,58,49,2021,"TEXAS"
"945","TOLEDO, UNIVERSITY OF",19,14,0,5,33,28,2021,"OHIO"
"946","TOURO UNIVERSITY",49,43,0,16,92,76,2021,"NEW YORK"
"947","TULANE UNIVERSITY",76,41,0,14,117,103,2021,"LOUISIANA"
"948","TULSA, UNIVERSITY OF",24,26,0,10,50,40,2021,"OKLAHOMA"
"949","UNIVERSITY OF BUFFALO-SUNY",55,47,0,8,102,94,2021,"NEW YORK"
"950","UNIVERSITY OF CALIFORNIA COLLEGE OF THE LAW, SAN FRANCISCO",132,92,0,42,224,182,2021,"CALIFORNIA"
"951","UNIVERSITY OF ILLINOIS CHICAGO SCHOOL OF LAW",109,86,0,50,195,145,2021,"ILLINOIS"
"952","UNIVERSITY OF MASSACHUSETTS DARTMOUTH",30,18,0,7,48,41,2021,"MASSACHUSETTS"
"953","UNIVERSITY OF NEVADA - LAS VEGAS",44,37,0,17,81,64,2021,"NEVADA"
"954","UTAH, UNIVERSITY OF",48,46,0,18,94,76,2021,"UTAH"
"955","VANDERBILT UNIVERSITY",74,47,0,16,121,105,2021,"TENNESSEE"
"956","VERMONT LAW SCHOOL",63,75,0,12,138,126,2021,"VERMONT"
"957","VILLANOVA UNIVERSITY",56,62,0,17,118,101,2021,"PENNSYLVANIA"
"958","VIRGINIA, UNIVERSITY OF",168,84,0,31,252,221,2021,"VIRGINIA"
"959","WAKE FOREST UNIVERSITY",46,41,0,15,87,72,2021,"NORTH CAROLINA"
"960","WASHBURN UNIVERSITY",39,26,0,8,65,57,2021,"KANSAS"
"961","WASHINGTON AND LEE UNIVERSITY",56,32,0,11,88,77,2021,"VIRGINIA"
"962","WASHINGTON UNIVERSITY",94,68,0,22,162,140,2021,"MISSOURI"
"963","WASHINGTON, UNIVERSITY OF",89,58,0,30,147,117,2021,"WASHINGTON"
"964","WAYNE STATE UNIVERSITY",54,45,0,20,99,79,2021,"MICHIGAN"
"965","WEST VIRGINIA UNIVERSITY",36,26,0,5,62,57,2021,"WEST VIRGINIA"
"966","COOLEY LAW SCHOOL",105,71,0,31,176,145,2021,NA
"967","WESTERN NEW ENGLAND UNIVERSITY",33,37,0,15,70,55,2021,"MASSACHUSETTS"
"968","WESTERN STATE COLLEGE OF LAW",25,22,0,11,47,36,2021,"CALIFORNIA"
"969","WIDENER UNIVERSITY-DELAWARE",41,39,0,9,80,71,2021,"DELAWARE"
"970","WIDENER-COMMONWEALTH",35,27,0,4,62,58,2021,"PENNSYLVANIA"
"971","WILLAMETTE UNIVERSITY",28,26,0,7,54,47,2021,"OREGON"
"972","WILLIAM AND MARY LAW SCHOOL",103,53,0,15,156,141,2021,"VIRGINIA"
"973","WISCONSIN, UNIVERSITY OF",75,62,0,23,137,114,2021,"WISCONSIN"
"974","WYOMING, UNIVERSITY OF",20,14,0,6,34,28,2021,"WYOMING"
"975","YALE UNIVERSITY",157,83,1,34,241,207,2021,"CONNECTICUT"
"976","AKRON, UNIVERSITY OF",37,20,0,4,57,53,2022,"OHIO"
"977","ALABAMA, UNIVERSITY OF",63,33,0,17,96,79,2022,"ALABAMA"
"978","ALBANY LAW SCHOOL",50,40,1,14,91,77,2022,"NEW YORK"
"979","AMERICAN UNIVERSITY",126,133,0,53,259,206,2022,"DISTRICT OF COLUMBIA"
"980","APPALACHIAN SCHOOL OF LAW",14,7,3,2,24,22,2022,"VIRGINIA"
"981","ARIZONA STATE UNIVERSITY",149,68,0,39,217,178,2022,"ARIZONA"
"982","ARIZONA, UNIVERSITY OF",83,73,0,34,156,122,2022,"ARIZONA"
"983","ARKANSAS, FAYETTEVILLE, UNIVERSITY OF",32,30,0,6,62,56,2022,"ARKANSAS"
"984","ARKANSAS, LITTLE ROCK, UNIVERSITY OF",46,41,0,13,87,74,2022,"ARKANSAS"
"985","ATLANTA'S JOHN MARSHALL LAW SCHOOL",17,18,0,7,35,28,2022,"GEORGIA"
"986","AVE MARIA SCHOOL OF LAW",20,13,0,3,33,30,2022,"FLORIDA"
"987","BALTIMORE, UNIVERSITY OF",91,70,0,26,161,135,2022,"MARYLAND"
"988","BARRY UNIVERSITY",37,32,0,20,69,49,2022,"FLORIDA"
"989","BAYLOR UNIVERSITY",118,58,0,17,176,159,2022,"TEXAS"
"990","BELMONT UNIVERSITY",37,17,0,9,54,45,2022,"TENNESSEE"
"991","BOSTON COLLEGE",86,90,0,26,177,151,2022,"MASSACHUSETTS"
"992","BOSTON UNIVERSITY",107,88,0,18,196,178,2022,"MASSACHUSETTS"
"993","BRIGHAM YOUNG UNIVERSITY",59,32,0,8,91,83,2022,"UTAH"
"994","BROOKLYN LAW SCHOOL",126,80,4,39,210,171,2022,"NEW YORK"
"995","CALIFORNIA WESTERN SCHOOL OF LAW",59,53,0,25,112,87,2022,"CALIFORNIA"
"996","CALIFORNIA-BERKELEY, UNIVERSITY OF",177,172,0,66,349,283,2022,"CALIFORNIA"
"997","CALIFORNIA-DAVIS, UNIVERSITY OF",63,58,0,38,121,83,2022,"CALIFORNIA"
"998","CALIFORNIA-IRVINE, UNIVERSITY OF",73,70,2,42,145,103,2022,"CALIFORNIA"
"999","CALIFORNIA-LOS ANGELES, UNIVERSITY OF",129,85,0,53,214,161,2022,"CALIFORNIA"
"1000","CAMPBELL UNIVERSITY",54,43,0,17,97,80,2022,"NORTH CAROLINA"
"1001","CAPITAL UNIVERSITY",52,27,0,13,79,66,2022,"OHIO"
"1002","CARDOZO SCHOOL OF LAW",166,146,0,40,312,272,2022,"NEW YORK"
"1003","CASE WESTERN RESERVE UNIVERSITY",75,39,0,12,114,102,2022,"OHIO"
"1004","CATHOLIC UNIVERSITY OF AMERICA",60,39,0,9,99,90,2022,"DISTRICT OF COLUMBIA"
"1005","CHAPMAN UNIVERSITY",60,47,0,18,107,89,2022,"CALIFORNIA"
"1006","CHARLESTON SCHOOL OF LAW",46,35,0,9,81,72,2022,"SOUTH CAROLINA"
"1007","CHICAGO, UNIVERSITY OF",127,55,0,33,182,149,2022,"ILLINOIS"
"1008","CHICAGO-KENT COLLEGE OF LAW-IIT",97,51,0,26,148,122,2022,"ILLINOIS"
"1009","CINCINNATI, UNIVERSITY OF",48,41,0,11,89,78,2022,"OHIO"
"1010","CITY UNIVERSITY OF NEW YORK",26,65,1,45,92,47,2022,"NEW YORK"
"1011","CLEVELAND STATE UNIVERSITY",55,38,0,12,93,81,2022,"OHIO"
"1012","COLORADO, UNIVERSITY OF",60,41,0,15,102,87,2022,"COLORADO"
"1013","COLUMBIA UNIVERSITY",229,174,0,73,403,330,2022,"NEW YORK"
"1014","CONNECTICUT, UNIVERSITY OF",93,58,0,21,151,130,2022,"CONNECTICUT"
"1015","CORNELL UNIVERSITY",118,77,1,25,196,171,2022,"NEW YORK"
"1016","CREIGHTON UNIVERSITY",39,26,0,8,65,57,2022,"NEBRASKA"
"1017","DAYTON, UNIVERSITY OF",50,49,0,19,99,80,2022,"OHIO"
"1018","DENVER, UNIVERSITY OF",91,70,1,20,162,142,2022,"COLORADO"
"1019","DEPAUL UNIVERSITY",68,65,4,36,137,101,2022,"ILLINOIS"
"1020","DETROIT MERCY, UNIVERSITY OF",44,45,0,14,89,75,2022,"MICHIGAN"
"1021","DISTRICT OF COLUMBIA",20,26,0,24,46,22,2022,"DISTRICT OF COLUMBIA"
"1022","DRAKE UNIVERSITY",38,40,0,12,78,66,2022,"IOWA"
"1023","DREXEL UNIVERSITY",67,66,0,27,133,106,2022,"PENNSYLVANIA"
"1024","DUKE UNIVERSITY",113,80,0,27,193,166,2022,"NORTH CAROLINA"
"1025","DUQUESNE UNIVERSITY",49,40,0,13,89,76,2022,"PENNSYLVANIA"
"1026","ELON UNIVERSITY",28,47,0,18,75,57,2022,"NORTH CAROLINA"
"1027","EMORY UNIVERSITY",98,95,0,41,193,152,2022,"GEORGIA"
"1028","FAULKNER UNIVERSITY",22,8,0,5,30,25,2022,"ALABAMA"
"1029","FLORIDA A&M UNIVERSITY",31,24,0,36,55,19,2022,"FLORIDA"
"1030","FLORIDA INTERNATIONAL UNIVERSITY",55,40,0,42,95,53,2022,"FLORIDA"
"1031","FLORIDA STATE UNIVERSITY",75,33,0,18,108,90,2022,"FLORIDA"
"1032","FLORIDA, UNIVERSITY OF",187,156,0,81,343,262,2022,"FLORIDA"
"1033","FORDHAM UNIVERSITY",218,163,0,50,381,331,2022,"NEW YORK"
"1034","GEORGE MASON UNIVERSITY",170,110,1,47,281,234,2022,"VIRGINIA"
"1035","GEORGE WASHINGTON UNIVERSITY",335,163,0,65,505,440,2022,"DISTRICT OF COLUMBIA"
"1036","GEORGETOWN UNIVERSITY",546,328,0,158,874,716,2022,"DISTRICT OF COLUMBIA"
"1037","GEORGIA STATE UNIVERSITY",78,71,0,27,149,122,2022,"GEORGIA"
"1038","GEORGIA, UNIVERSITY OF",66,45,0,19,111,92,2022,"GEORGIA"
"1039","GOLDEN GATE UNIVERSITY",59,62,0,22,121,99,2022,"CALIFORNIA"
"1040","GONZAGA UNIVERSITY",34,37,0,14,71,57,2022,"WASHINGTON"
"1041","HARVARD UNIVERSITY",212,135,0,76,347,271,2022,"MASSACHUSETTS"
"1042","HAWAII, UNIVERSITY OF",64,51,0,45,115,70,2022,"HAWAII"
"1043","HOFSTRA UNIVERSITY",73,54,0,12,127,115,2022,"NEW YORK"
"1044","HOUSTON, UNIVERSITY OF",142,84,0,44,226,182,2022,"TEXAS"
"1045","HOWARD UNIVERSITY",52,44,0,82,100,18,2022,"DISTRICT OF COLUMBIA"
"1046","IDAHO, UNIVERSITY OF",60,51,0,0,111,111,2022,"IDAHO"
"1047","ILLINOIS, UNIVERSITY OF",71,55,0,21,126,105,2022,"ILLINOIS"
"1048","INDIANA UNIVERSITY - BLOOMINGTON",64,48,0,20,112,92,2022,"INDIANA"
"1049","INDIANA UNIVERSITY - INDIANAPOLIS",90,80,0,25,170,145,2022,"INDIANA"
"1050","INTER AMERICAN UNIVERSITY OF PUERTO RICO",68,38,0,108,110,2,2022,"PUERTO RICO"
"1051","IOWA, UNIVERSITY OF",53,39,0,16,92,76,2022,"IOWA"
"1052","KANSAS, UNIVERSITY OF",46,29,0,10,75,65,2022,"KANSAS"
"1053","KENTUCKY, UNIVERSITY OF",33,33,0,6,66,60,2022,"KENTUCKY"
"1054","LEWIS AND CLARK COLLEGE",79,55,0,25,134,109,2022,"OREGON"
"1055","LIBERTY UNIVERSITY",22,13,0,8,35,27,2022,"VIRGINIA"
"1056","LINCOLN MEMORIAL",19,29,0,7,49,42,2022,"DISTRICT OF COLUMBIA"
"1057","LOUISIANA STATE UNIVERSITY",59,42,0,14,101,87,2022,"LOUISIANA"
"1058","LOUISVILLE, UNIVERSITY OF",37,25,0,11,62,51,2022,"KENTUCKY"
"1059","LOYOLA MARYMOUNT UNIVERSITY-LOS ANGELES",106,87,0,37,193,156,2022,"CALIFORNIA"
"1060","LOYOLA UNIVERSITY-CHICAGO",140,162,0,56,303,247,2022,"ILLINOIS"
"1061","LOYOLA UNIVERSITY-NEW ORLEANS",58,34,0,20,92,72,2022,"LOUISIANA"
"1062","MAINE, UNIVERSITY OF",36,33,2,5,71,66,2022,"MAINE"
"1063","MARQUETTE UNIVERSITY",76,49,0,10,125,115,2022,"WISCONSIN"
"1064","MARYLAND, UNIVERSITY OF",103,79,0,38,182,144,2022,"MARYLAND"
"1065","MCGEORGE SCHOOL OF LAW",60,48,0,32,108,76,2022,"CALIFORNIA"
"1066","MEMPHIS, UNIVERSITY OF",40,26,0,16,66,50,2022,"TENNESSEE"
"1067","MERCER UNIVERSITY",44,27,0,7,71,64,2022,"GEORGIA"
"1068","MIAMI, UNIVERSITY OF",246,135,0,95,381,286,2022,"FLORIDA"
"1069","MICHIGAN STATE UNIVERSITY",66,48,0,13,114,101,2022,"MICHIGAN"
"1070","MICHIGAN, UNIVERSITY OF",112,71,0,26,183,157,2022,"MICHIGAN"
"1071","MINNESOTA, UNIVERSITY OF",169,114,0,40,283,243,2022,"MINNESOTA"
"1072","MISSISSIPPI COLLEGE",25,22,0,10,47,37,2022,"MISSISSIPPI"
"1073","MISSISSIPPI, UNIVERSITY OF",42,29,0,8,71,63,2022,"MISSISSIPPI"
"1074","MISSOURI, UNIVERSITY OF",28,18,0,7,46,39,2022,"MISSOURI"
"1075","MISSOURI-KANSAS CITY, UNIVERSITY OF",68,50,0,11,118,107,2022,"MISSOURI"
"1076","MITCHELL | HAMLINE",69,90,0,22,159,137,2022,NA
"1077","MONTANA, UNIVERSITY OF",17,15,0,4,32,28,2022,"MONTANA"
"1078","NEBRASKA, UNIVERSITY OF",51,33,0,9,84,75,2022,"NEBRASKA"
"1079","NEW ENGLAND LAW | BOSTON",87,68,0,19,155,136,2022,"MASSACHUSETTS"
"1080","NEW HAMPSHIRE, UNIVERSITY OF",69,55,3,5,127,122,2022,"NEW HAMPSHIRE"
"1081","NEW MEXICO, UNIVERSITY OF",44,52,0,39,96,57,2022,"NEW MEXICO"
"1082","NEW YORK LAW SCHOOL",133,107,0,55,240,185,2022,"NEW YORK"
"1083","NEW YORK UNIVERSITY",239,137,0,64,376,312,2022,"NEW YORK"
"1084","NORTH CAROLINA CENTRAL UNIVERSITY",30,43,0,44,73,29,2022,"NORTH CAROLINA"
"1085","NORTH CAROLINA, UNIVERSITY OF",72,68,0,20,140,120,2022,"NORTH CAROLINA"
"1086","NORTH DAKOTA, UNIVERSITY OF",15,15,0,2,30,28,2022,"NORTH DAKOTA"
"1087","NORTHEASTERN UNIVERSITY SCHOOL OF LAW",63,54,1,25,119,94,2022,NA
"1088","NORTHERN ILLINOIS UNIVERSITY",31,22,0,12,53,41,2022,"ILLINOIS"
"1089","NORTHERN KENTUCKY UNIVERSITY",43,25,0,9,68,59,2022,"KENTUCKY"
"1090","NORTHWESTERN UNIVERSITY",148,89,0,40,237,197,2022,"ILLINOIS"
"1091","NOTRE DAME, UNIVERSITY OF",93,40,2,18,135,117,2022,"INDIANA"
"1092","NOVA SOUTHEASTERN UNIVERSITY",38,53,0,28,91,63,2022,"FLORIDA"
"1093","OHIO NORTHERN UNIVERSITY",16,7,0,2,23,21,2022,"OHIO"
"1094","OHIO STATE UNIVERSITY",87,61,0,18,148,130,2022,"OHIO"
"1095","OKLAHOMA CITY UNIVERSITY",46,41,0,18,87,69,2022,"OKLAHOMA"
"1096","OKLAHOMA, UNIVERSITY OF",44,28,0,12,72,60,2022,"OKLAHOMA"
"1097","OREGON, UNIVERSITY OF",37,50,0,15,87,72,2022,"OREGON"
"1098","PACE UNIVERSITY",72,63,1,19,136,117,2022,"NEW YORK"
"1099","PENNSYLVANIA STATE - DICKINSON LAW",26,26,1,17,53,36,2022,"PENNSYLVANIA"
"1100","PENNSYLVANIA STATE - PENN STATE LAW",45,32,1,13,78,65,2022,"PENNSYLVANIA"
"1101","PENNSYLVANIA, UNIVERSITY OF",161,114,13,63,288,225,2022,"PENNSYLVANIA"
"1102","PEPPERDINE UNIVERSITY",93,41,0,29,134,105,2022,"CALIFORNIA"
"1103","PITTSBURGH, UNIVERSITY OF",97,48,0,16,145,129,2022,"PENNSYLVANIA"
"1104","PONTIFICAL CATHOLIC UNIVERSITY OF P.R.",51,27,0,78,78,0,2022,"PUERTO RICO"
"1105","PUERTO RICO, UNIVERSITY OF",75,51,0,121,126,5,2022,"PUERTO RICO"
"1106","QUINNIPIAC UNIVERSITY",73,56,0,16,129,113,2022,"CONNECTICUT"
"1107","REGENT UNIVERSITY",51,18,0,12,69,57,2022,"VIRGINIA"
"1108","RICHMOND, UNIVERSITY OF",65,60,0,18,125,107,2022,"VIRGINIA"
"1109","ROGER WILLIAMS UNIVERSITY",47,44,0,12,91,79,2022,"RHODE ISLAND"
"1110","RUTGERS UNIVERSITY",113,92,0,43,205,162,2022,"NEW JERSEY"
"1111","SAINT LOUIS UNIVERSITY",60,58,0,18,118,100,2022,"MISSOURI"
"1112","SAMFORD UNIVERSITY",46,32,0,11,80,69,2022,"ALABAMA"
"1113","SAN DIEGO, UNIVERSITY OF",89,59,0,24,148,124,2022,"CALIFORNIA"
"1114","SAN FRANCISCO, UNIVERSITY OF",37,38,0,19,75,56,2022,"CALIFORNIA"
"1115","SANTA CLARA UNIVERSITY",66,72,2,30,141,111,2022,"CALIFORNIA"
"1116","SEATTLE UNIVERSITY",83,74,0,41,157,116,2022,"WASHINGTON"
"1117","SETON HALL UNIVERSITY",82,62,2,26,146,120,2022,"NEW JERSEY"
"1118","SOUTH CAROLINA, UNIVERSITY OF",79,48,0,21,127,106,2022,"SOUTH CAROLINA"
"1119","SOUTH DAKOTA, UNIVERSITY OF",20,20,0,4,40,36,2022,"SOUTH DAKOTA"
"1120","SOUTH TEXAS COLLEGE OF LAW HOUSTON",70,43,0,19,113,94,2022,"TEXAS"
"1121","SOUTHERN CALIFORNIA, UNIVERSITY OF",110,71,0,32,181,149,2022,"CALIFORNIA"
"1122","SOUTHERN ILLINOIS UNIVERSITY-CARBONDALE",18,23,0,6,41,35,2022,"ILLINOIS"
"1123","SOUTHERN METHODIST UNIVERSITY",98,47,0,22,145,123,2022,"TEXAS"
"1124","SOUTHERN UNIVERSITY",75,91,0,120,166,46,2022,"LOUISIANA"
"1125","SOUTHWESTERN LAW SCHOOL",87,80,0,47,167,120,2022,"CALIFORNIA"
"1126","ST. JOHN'S UNIVERSITY",88,78,0,28,166,138,2022,"NEW YORK"
"1127","ST. MARY'S UNIVERSITY",72,31,0,27,104,77,2022,"TEXAS"
"1128","ST. THOMAS UNIVERSITY (FLORIDA)",61,41,0,33,102,69,2022,"FLORIDA"
"1129","ST. THOMAS, UNIVERSITY OF (MINNESOTA)",92,65,0,28,157,129,2022,"MINNESOTA"
"1130","STANFORD UNIVERSITY",110,76,0,37,186,149,2022,"CALIFORNIA"
"1131","STETSON UNIVERSITY",93,84,3,33,180,147,2022,"FLORIDA"
"1132","SUFFOLK UNIVERSITY",93,65,0,27,158,131,2022,"MASSACHUSETTS"
"1133","SYRACUSE UNIVERSITY",53,35,0,12,88,76,2022,"NEW YORK"
"1134","TEMPLE UNIVERSITY",116,99,0,40,216,176,2022,"PENNSYLVANIA"
"1135","TENNESSEE, UNIVERSITY OF",58,40,0,16,98,82,2022,"TENNESSEE"
"1136","TEXAS A&M UNIVERSITY",70,49,0,19,119,100,2022,"TEXAS"
"1137","TEXAS AT AUSTIN, UNIVERSITY OF",214,93,0,34,307,273,2022,"TEXAS"
"1138","TEXAS SOUTHERN UNIVERSITY THURGOOD MARSHALL SCHOOL OF LAW",39,53,0,76,92,16,2022,NA
"1139","TEXAS TECH UNIVERSITY",37,21,0,7,58,51,2022,"TEXAS"
"1140","COOLEY LAW SCHOOL",78,63,0,29,141,112,2022,NA
"1141","TOLEDO, UNIVERSITY OF",22,20,0,3,42,39,2022,"OHIO"
"1142","TOURO UNIVERSITY",41,45,0,16,86,70,2022,"NEW YORK"
"1143","TULANE UNIVERSITY",76,46,0,17,122,105,2022,"LOUISIANA"
"1144","TULSA, UNIVERSITY OF",26,27,0,14,53,39,2022,"OKLAHOMA"
"1145","UNIVERSITY OF BUFFALO-SUNY",53,44,0,9,97,88,2022,"NEW YORK"
"1146","UNIVERSITY OF CALIFORNIA COLLEGE OF THE LAW, SAN FRANCISCO",148,108,0,63,256,193,2022,"CALIFORNIA"
"1147","UNIVERSITY OF ILLINOIS CHICAGO SCHOOL OF LAW",95,82,0,53,177,124,2022,"ILLINOIS"
"1148","UNIVERSITY OF MASSACHUSETTS DARTMOUTH",35,25,0,11,60,49,2022,"MASSACHUSETTS"
"1149","UNIVERSITY OF NEVADA - LAS VEGAS",45,50,0,18,95,77,2022,"NEVADA"
"1150","UTAH, UNIVERSITY OF",62,44,1,22,107,85,2022,"UTAH"
"1151","VANDERBILT UNIVERSITY",83,56,0,19,139,120,2022,"TENNESSEE"
"1152","VERMONT LAW SCHOOL",73,92,1,20,166,146,2022,"VERMONT"
"1153","VILLANOVA UNIVERSITY",61,56,0,15,117,102,2022,"PENNSYLVANIA"
"1154","VIRGINIA, UNIVERSITY OF",163,82,0,31,245,214,2022,"VIRGINIA"
"1155","WAKE FOREST UNIVERSITY",60,49,0,22,109,87,2022,"NORTH CAROLINA"
"1156","WASHBURN UNIVERSITY",34,30,0,12,64,52,2022,"KANSAS"
"1157","WASHINGTON AND LEE UNIVERSITY",59,30,0,12,89,77,2022,"VIRGINIA"
"1158","WASHINGTON UNIVERSITY",96,73,0,26,169,143,2022,"MISSOURI"
"1159","WASHINGTON, UNIVERSITY OF",93,68,0,30,161,131,2022,"WASHINGTON"
"1160","WAYNE STATE UNIVERSITY",51,47,0,19,98,79,2022,"MICHIGAN"
"1161","WEST VIRGINIA UNIVERSITY",36,28,0,6,64,58,2022,"WEST VIRGINIA"
"1162","WESTERN NEW ENGLAND UNIVERSITY",30,37,0,9,69,60,2022,"MASSACHUSETTS"
"1163","WESTERN STATE COLLEGE OF LAW",29,16,0,14,45,31,2022,"CALIFORNIA"
"1164","WIDENER UNIVERSITY-DELAWARE",44,40,0,7,84,77,2022,"DELAWARE"
"1165","WIDENER-COMMONWEALTH",35,26,0,4,61,57,2022,"PENNSYLVANIA"
"1166","WILLAMETTE UNIVERSITY",30,24,0,9,55,46,2022,"OREGON"
"1167","WILLIAM AND MARY LAW SCHOOL",106,52,0,14,162,148,2022,"VIRGINIA"
"1168","WISCONSIN, UNIVERSITY OF",81,65,0,26,146,120,2022,"WISCONSIN"
"1169","WYOMING, UNIVERSITY OF",24,12,0,7,36,29,2022,"WYOMING"
"1170","YALE UNIVERSITY",165,95,0,45,260,215,2022,"CONNECTICUT"
"1171","AKRON, UNIVERSITY OF",39,31,0,6,70,64,2023,"OHIO"
"1172","ALABAMA, UNIVERSITY OF",62,35,0,18,97,79,2023,"ALABAMA"
"1173","ALBANY LAW SCHOOL",49,49,0,16,99,83,2023,"NEW YORK"
"1174","AMERICAN UNIVERSITY",152,141,0,78,293,215,2023,"DISTRICT OF COLUMBIA"
"1175","APPALACHIAN SCHOOL OF LAW",16,9,0,3,25,22,2023,"VIRGINIA"
"1176","ARIZONA STATE UNIVERSITY",156,77,0,40,233,193,2023,"ARIZONA"
"1177","ARIZONA, UNIVERSITY OF",90,79,0,47,169,122,2023,"ARIZONA"
"1178","ARKANSAS, FAYETTEVILLE, UNIVERSITY OF",35,37,0,9,72,63,2023,"ARKANSAS"
"1179","ARKANSAS, LITTLE ROCK, UNIVERSITY OF",58,46,0,16,104,88,2023,"ARKANSAS"
"1180","ATLANTA'S JOHN MARSHALL LAW SCHOOL",16,19,0,10,35,25,2023,"GEORGIA"
"1181","AVE MARIA SCHOOL OF LAW",24,17,0,5,41,36,2023,"FLORIDA"
"1182","BALTIMORE, UNIVERSITY OF",84,75,0,22,163,141,2023,"MARYLAND"
"1183","BARRY UNIVERSITY",33,34,0,27,67,40,2023,"FLORIDA"
"1184","BAYLOR UNIVERSITY",111,72,0,32,183,151,2023,"TEXAS"
"1185","BELMONT UNIVERSITY",32,18,0,7,50,43,2023,"TENNESSEE"
"1186","BOSTON COLLEGE",124,89,0,42,213,171,2023,"MASSACHUSETTS"
"1187","BOSTON UNIVERSITY",126,86,0,32,213,181,2023,"MASSACHUSETTS"
"1188","BRIGHAM YOUNG UNIVERSITY",68,33,0,12,101,89,2023,"UTAH"
"1189","BROOKLYN LAW SCHOOL",135,81,0,50,219,169,2023,"NEW YORK"
"1190","CALIFORNIA WESTERN SCHOOL OF LAW",56,51,0,24,107,83,2023,"CALIFORNIA"
"1191","CALIFORNIA-BERKELEY, UNIVERSITY OF",175,163,0,78,338,260,2023,"CALIFORNIA"
"1192","CALIFORNIA-DAVIS, UNIVERSITY OF",56,46,0,33,102,69,2023,"CALIFORNIA"
"1193","CALIFORNIA-IRVINE, UNIVERSITY OF",63,62,1,42,133,91,2023,"CALIFORNIA"
"1194","CALIFORNIA-LOS ANGELES, UNIVERSITY OF",144,105,0,70,255,185,2023,"CALIFORNIA"
"1195","CAMPBELL UNIVERSITY",56,56,0,19,112,93,2023,"NORTH CAROLINA"
"1196","CAPITAL UNIVERSITY",53,24,0,11,77,66,2023,"OHIO"
"1197","CARDOZO SCHOOL OF LAW",168,140,0,51,311,260,2023,"NEW YORK"
"1198","CASE WESTERN RESERVE UNIVERSITY",83,40,0,8,124,116,2023,"OHIO"
"1199","CATHOLIC UNIVERSITY OF AMERICA",71,43,0,16,114,98,2023,"DISTRICT OF COLUMBIA"
"1200","CHAPMAN UNIVERSITY",61,47,0,20,108,88,2023,"CALIFORNIA"
"1201","CHARLESTON SCHOOL OF LAW",40,36,0,9,76,67,2023,"SOUTH CAROLINA"
"1202","CHICAGO-KENT COLLEGE OF LAW-IIT",98,49,0,23,147,124,2023,"ILLINOIS"
"1203","CHICAGO, UNIVERSITY OF",146,69,0,35,216,181,2023,"ILLINOIS"
"1204","CINCINNATI, UNIVERSITY OF",59,53,0,14,112,98,2023,"OHIO"
"1205","CITY UNIVERSITY OF NEW YORK",35,57,0,47,93,46,2023,"NEW YORK"
"1206","CLEVELAND STATE UNIVERSITY",123,75,0,25,198,173,2023,"OHIO"
"1207","COLORADO, UNIVERSITY OF",67,53,0,15,122,107,2023,"COLORADO"
"1208","COLUMBIA UNIVERSITY",274,175,1,98,450,352,2023,"NEW YORK"
"1209","CONNECTICUT, UNIVERSITY OF",93,69,0,25,162,137,2023,"CONNECTICUT"
"1210","COOLEY LAW SCHOOL",70,45,0,25,115,90,2023,NA
"1211","CORNELL UNIVERSITY",130,83,0,33,213,180,2023,"NEW YORK"
"1212","CREIGHTON UNIVERSITY",45,24,0,7,69,62,2023,"NEBRASKA"
"1213","DAYTON, UNIVERSITY OF",46,56,0,25,102,77,2023,"OHIO"
"1214","DENVER, UNIVERSITY OF",90,74,0,21,164,143,2023,"COLORADO"
"1215","DEPAUL UNIVERSITY",71,63,0,36,140,104,2023,"ILLINOIS"
"1216","DETROIT MERCY, UNIVERSITY OF",41,47,0,11,88,77,2023,"MICHIGAN"
"1217","DISTRICT OF COLUMBIA",26,30,0,31,56,25,2023,"DISTRICT OF COLUMBIA"
"1218","DRAKE UNIVERSITY",42,46,0,11,88,77,2023,"IOWA"
"1219","DREXEL UNIVERSITY",65,73,0,30,138,108,2023,"PENNSYLVANIA"
"1220","DUKE UNIVERSITY",114,97,0,35,211,176,2023,"NORTH CAROLINA"
"1221","DUQUESNE UNIVERSITY",54,40,0,10,94,84,2023,"PENNSYLVANIA"
"1222","ELON UNIVERSITY",24,40,0,18,64,46,2023,"NORTH CAROLINA"
"1223","EMORY UNIVERSITY",106,92,0,39,198,159,2023,"GEORGIA"
"1224","FAULKNER UNIVERSITY",24,10,0,4,34,30,2023,"ALABAMA"
"1225","FLORIDA A&M UNIVERSITY",26,25,0,36,51,15,2023,"FLORIDA"
"1226","FLORIDA INTERNATIONAL UNIVERSITY",60,42,0,43,103,60,2023,"FLORIDA"
"1227","FLORIDA STATE UNIVERSITY",76,48,0,24,124,100,2023,"FLORIDA"
"1228","FLORIDA, UNIVERSITY OF",160,99,0,59,259,200,2023,"FLORIDA"
"1229","FORDHAM UNIVERSITY",238,185,0,82,423,341,2023,"NEW YORK"
"1230","GEORGE MASON UNIVERSITY",170,109,1,45,280,235,2023,"VIRGINIA"
"1231","GEORGE WASHINGTON UNIVERSITY",358,208,1,219,594,375,2023,"DISTRICT OF COLUMBIA"
"1232","GEORGETOWN UNIVERSITY",497,319,0,160,816,656,2023,"DISTRICT OF COLUMBIA"
"1233","GEORGIA STATE UNIVERSITY",76,79,0,31,155,124,2023,"GEORGIA"
"1234","GEORGIA, UNIVERSITY OF",73,52,0,18,125,107,2023,"GEORGIA"
"1235","GOLDEN GATE UNIVERSITY",42,49,0,20,91,71,2023,"CALIFORNIA"
"1236","GONZAGA UNIVERSITY",38,38,0,20,76,56,2023,"WASHINGTON"
"1237","HARVARD UNIVERSITY",219,150,0,94,369,275,2023,"MASSACHUSETTS"
"1238","HAWAII, UNIVERSITY OF",62,46,0,52,108,56,2023,"HAWAII"
"1239","HOFSTRA UNIVERSITY",92,65,0,24,157,133,2023,"NEW YORK"
"1240","HOUSTON, UNIVERSITY OF",142,92,0,52,234,182,2023,"TEXAS"
"1241","HOWARD UNIVERSITY",57,53,0,86,110,24,2023,"DISTRICT OF COLUMBIA"
"1242","IDAHO, UNIVERSITY OF",54,40,0,0,94,94,2023,"IDAHO"
"1243","ILLINOIS, UNIVERSITY OF",78,59,0,25,137,112,2023,"ILLINOIS"
"1244","INDIANA UNIVERSITY - BLOOMINGTON",74,51,0,18,125,107,2023,"INDIANA"
"1245","INDIANA UNIVERSITY - INDIANAPOLIS",90,91,0,23,181,158,2023,"INDIANA"
"1246","INTER AMERICAN UNIVERSITY OF PUERTO RICO",57,35,0,90,92,2,2023,"PUERTO RICO"
"1247","IOWA, UNIVERSITY OF",51,42,0,18,93,75,2023,"IOWA"
"1248","KANSAS, UNIVERSITY OF",43,31,0,12,74,62,2023,"KANSAS"
"1249","KENTUCKY, UNIVERSITY OF",42,31,1,5,74,69,2023,"KENTUCKY"
"1250","LEWIS AND CLARK COLLEGE",115,76,0,32,192,160,2023,"OREGON"
"1251","LIBERTY UNIVERSITY",26,13,0,9,39,30,2023,"VIRGINIA"
"1252","LINCOLN MEMORIAL",21,27,0,14,48,34,2023,"DISTRICT OF COLUMBIA"
"1253","LOUISIANA STATE UNIVERSITY",59,44,0,14,103,89,2023,"LOUISIANA"
"1254","LOUISVILLE, UNIVERSITY OF",31,27,0,11,58,47,2023,"KENTUCKY"
"1255","LOYOLA MARYMOUNT UNIVERSITY-LOS ANGELES",110,86,0,41,196,155,2023,"CALIFORNIA"
"1256","LOYOLA UNIVERSITY-CHICAGO",121,149,0,66,270,204,2023,"ILLINOIS"
"1257","LOYOLA UNIVERSITY-NEW ORLEANS",61,34,0,27,95,68,2023,"LOUISIANA"
"1258","MAINE, UNIVERSITY OF",50,29,0,9,79,70,2023,"MAINE"
"1259","MARQUETTE UNIVERSITY",66,49,0,10,115,105,2023,"WISCONSIN"
"1260","MARYLAND, UNIVERSITY OF",113,81,0,38,194,156,2023,"MARYLAND"
"1261","MCGEORGE SCHOOL OF LAW",60,52,0,29,112,83,2023,"CALIFORNIA"
"1262","MEMPHIS, UNIVERSITY OF",37,32,0,15,69,54,2023,"TENNESSEE"
"1263","MERCER UNIVERSITY",44,29,0,8,73,65,2023,"GEORGIA"
"1264","MIAMI, UNIVERSITY OF",252,130,0,94,382,288,2023,"FLORIDA"
"1265","MICHIGAN STATE UNIVERSITY",74,52,0,23,128,105,2023,"MICHIGAN"
"1266","MICHIGAN, UNIVERSITY OF",145,78,0,39,223,184,2023,"MICHIGAN"
"1267","MINNESOTA, UNIVERSITY OF",165,134,0,38,299,261,2023,"MINNESOTA"
"1268","MISSISSIPPI COLLEGE",22,24,0,7,46,39,2023,"MISSISSIPPI"
"1269","MISSISSIPPI, UNIVERSITY OF",45,29,0,11,74,63,2023,"MISSISSIPPI"
"1270","MISSOURI, UNIVERSITY OF",38,23,0,9,61,52,2023,"MISSOURI"
"1271","MISSOURI-KANSAS CITY, UNIVERSITY OF",67,46,0,12,113,101,2023,"MISSOURI"
"1272","MITCHELL | HAMLINE",66,79,0,24,146,122,2023,NA
"1273","MONTANA, UNIVERSITY OF",18,25,0,7,43,36,2023,"MONTANA"
"1274","NEBRASKA, UNIVERSITY OF",53,35,0,8,88,80,2023,"NEBRASKA"
"1275","NEW ENGLAND LAW | BOSTON",91,69,0,21,160,139,2023,"MASSACHUSETTS"
"1276","NEW HAMPSHIRE, UNIVERSITY OF",70,64,0,10,143,133,2023,"NEW HAMPSHIRE"
"1277","NEW MEXICO, UNIVERSITY OF",48,58,0,42,106,64,2023,"NEW MEXICO"
"1278","NEW YORK LAW SCHOOL",124,102,0,46,232,186,2023,"NEW YORK"
"1279","NEW YORK UNIVERSITY",243,156,0,83,399,316,2023,"NEW YORK"
"1280","NORTH CAROLINA CENTRAL UNIVERSITY",26,39,0,45,65,20,2023,"NORTH CAROLINA"
"1281","NORTH CAROLINA, UNIVERSITY OF",86,79,1,20,166,146,2023,"NORTH CAROLINA"
"1282","NORTH DAKOTA, UNIVERSITY OF",20,14,0,5,34,29,2023,"NORTH DAKOTA"
"1283","NORTHEASTERN UNIVERSITY SCHOOL OF LAW",62,72,0,35,134,99,2023,NA
"1284","NORTHERN ILLINOIS UNIVERSITY",34,25,0,18,59,41,2023,"ILLINOIS"
"1285","NORTHERN KENTUCKY UNIVERSITY",40,26,0,12,66,54,2023,"KENTUCKY"
"1286","NORTHWESTERN UNIVERSITY",157,104,0,47,261,214,2023,"ILLINOIS"
"1287","NOTRE DAME, UNIVERSITY OF",100,33,0,13,134,121,2023,"INDIANA"
"1288","NOVA SOUTHEASTERN UNIVERSITY",44,44,0,30,88,58,2023,"FLORIDA"
"1289","OHIO NORTHERN UNIVERSITY",15,8,0,3,23,20,2023,"OHIO"
"1290","OKLAHOMA CITY UNIVERSITY",47,36,0,19,83,64,2023,"OKLAHOMA"
"1291","OKLAHOMA, UNIVERSITY OF",41,33,0,16,77,61,2023,"OKLAHOMA"
"1292","OREGON, UNIVERSITY OF",40,54,0,17,95,78,2023,"OREGON"
"1293","PACE UNIVERSITY",80,64,0,20,145,125,2023,"NEW YORK"
"1294","PENNSYLVANIA STATE - DICKINSON LAW",23,33,0,19,57,38,2023,"PENNSYLVANIA"
"1295","PENNSYLVANIA STATE - PENN STATE LAW",47,28,0,13,75,62,2023,"PENNSYLVANIA"
"1296","PENNSYLVANIA, UNIVERSITY OF",167,121,0,66,291,225,2023,"PENNSYLVANIA"
"1297","PEPPERDINE UNIVERSITY",92,57,0,29,149,120,2023,"CALIFORNIA"
"1298","PITTSBURGH, UNIVERSITY OF",112,64,0,22,176,154,2023,"PENNSYLVANIA"
"1299","PONTIFICAL CATHOLIC UNIVERSITY OF P.R.",49,26,0,75,75,0,2023,"PUERTO RICO"
"1300","PUERTO RICO, UNIVERSITY OF",65,45,0,105,110,5,2023,"PUERTO RICO"
"1301","QUINNIPIAC UNIVERSITY",78,60,0,17,138,121,2023,"CONNECTICUT"
"1302","REGENT UNIVERSITY",44,14,0,12,58,46,2023,"VIRGINIA"
"1303","RICHMOND, UNIVERSITY OF",69,68,0,22,137,115,2023,"VIRGINIA"
"1304","ROGER WILLIAMS UNIVERSITY",47,58,0,26,105,79,2023,"RHODE ISLAND"
"1305","RUTGERS UNIVERSITY",121,104,0,51,225,174,2023,"NEW JERSEY"
"1306","SAINT LOUIS UNIVERSITY",62,69,0,21,131,110,2023,"MISSOURI"
"1307","SAMFORD UNIVERSITY",49,33,0,12,82,70,2023,"ALABAMA"
"1308","SAN DIEGO, UNIVERSITY OF",89,62,0,24,151,127,2023,"CALIFORNIA"
"1309","SAN FRANCISCO, UNIVERSITY OF",35,39,0,25,75,50,2023,"CALIFORNIA"
"1310","SANTA CLARA UNIVERSITY",67,84,0,35,152,117,2023,"CALIFORNIA"
"1311","SEATTLE UNIVERSITY",83,82,0,44,165,121,2023,"WASHINGTON"
"1312","SETON HALL UNIVERSITY",91,73,1,27,166,139,2023,"NEW JERSEY"
"1313","SOUTH CAROLINA, UNIVERSITY OF",80,56,0,31,136,105,2023,"SOUTH CAROLINA"
"1314","SOUTH DAKOTA, UNIVERSITY OF",24,18,0,4,42,38,2023,"SOUTH DAKOTA"
"1315","SOUTH TEXAS COLLEGE OF LAW HOUSTON",77,49,0,26,126,100,2023,"TEXAS"
"1316","SOUTHERN CALIFORNIA, UNIVERSITY OF",113,72,1,43,186,143,2023,"CALIFORNIA"
"1317","SOUTHERN ILLINOIS UNIVERSITY-CARBONDALE",20,24,0,8,44,36,2023,"ILLINOIS"
"1318","SOUTHERN METHODIST UNIVERSITY",112,54,0,33,166,133,2023,"TEXAS"
"1319","SOUTHERN UNIVERSITY",63,67,0,91,130,39,2023,"LOUISIANA"
"1320","SOUTHWESTERN LAW SCHOOL",93,86,1,53,180,127,2023,"CALIFORNIA"
"1321","ST. THOMAS, UNIVERSITY OF (MINNESOTA)",83,78,0,29,161,132,2023,"MINNESOTA"
"1322","ST. JOHN'S UNIVERSITY",80,86,2,33,168,135,2023,"NEW YORK"
"1323","ST. MARY'S UNIVERSITY",69,35,0,26,104,78,2023,"TEXAS"
"1324","ST. THOMAS UNIVERSITY (FLORIDA)",75,43,0,38,118,80,2023,"FLORIDA"
"1325","STANFORD UNIVERSITY",101,91,0,38,192,154,2023,"CALIFORNIA"
"1326","STETSON UNIVERSITY",93,86,0,24,181,157,2023,"FLORIDA"
"1327","SUFFOLK UNIVERSITY",95,68,0,26,163,137,2023,"MASSACHUSETTS"
"1328","SYRACUSE UNIVERSITY",54,38,0,13,92,79,2023,"NEW YORK"
"1329","TEMPLE UNIVERSITY",116,108,0,50,224,174,2023,"PENNSYLVANIA"
"1330","TENNESSEE, UNIVERSITY OF",61,41,0,15,102,87,2023,"TENNESSEE"
"1331","TEXAS A&M UNIVERSITY",86,60,0,22,146,124,2023,"TEXAS"
"1332","TEXAS AT AUSTIN, UNIVERSITY OF",213,98,0,42,311,269,2023,"TEXAS"
"1333","TEXAS SOUTHERN UNIVERSITY THURGOOD MARSHALL SCHOOL OF LAW",34,49,0,69,83,14,2023,NA
"1334","TEXAS TECH UNIVERSITY",41,27,0,8,68,60,2023,"TEXAS"
"1335","OHIO STATE UNIVERSITY",75,61,0,24,136,112,2023,"OHIO"
"1336","TOURO UNIVERSITY",45,46,0,18,92,74,2023,"NEW YORK"
"1337","TULANE UNIVERSITY",81,42,0,14,123,109,2023,"LOUISIANA"
"1338","TULSA, UNIVERSITY OF",32,32,0,17,64,47,2023,"OKLAHOMA"
"1339","UNIVERSITY OF BUFFALO-SUNY",63,55,0,7,118,111,2023,"NEW YORK"
"1340","UNIVERSITY OF CALIFORNIA COLLEGE OF THE LAW, SAN FRANCISCO",155,120,0,74,279,205,2023,"CALIFORNIA"
"1341","UNIVERSITY OF ILLINOIS CHICAGO SCHOOL OF LAW",99,89,0,54,188,134,2023,"ILLINOIS"
"1342","UNIVERSITY OF MASSACHUSETTS DARTMOUTH",41,18,0,8,59,51,2023,"MASSACHUSETTS"
"1343","UNIVERSITY OF NEVADA - LAS VEGAS",55,55,0,26,110,84,2023,"NEVADA"
"1344","TOLEDO, UNIVERSITY OF",28,27,0,8,55,47,2023,"OHIO"
"1345","UTAH, UNIVERSITY OF",59,47,0,18,108,90,2023,"UTAH"
"1346","VANDERBILT UNIVERSITY",98,59,0,24,157,133,2023,"TENNESSEE"
"1347","VERMONT LAW SCHOOL",69,100,1,28,172,144,2023,"VERMONT"
"1348","VILLANOVA UNIVERSITY",75,53,0,18,128,110,2023,"PENNSYLVANIA"
"1349","VIRGINIA, UNIVERSITY OF",177,99,0,36,276,240,2023,"VIRGINIA"
"1350","WAKE FOREST UNIVERSITY",52,45,0,16,97,81,2023,"NORTH CAROLINA"
"1351","WASHBURN UNIVERSITY",32,27,0,11,59,48,2023,"KANSAS"
"1352","WASHINGTON AND LEE UNIVERSITY",65,30,0,15,95,80,2023,"VIRGINIA"
"1353","WASHINGTON UNIVERSITY",122,106,0,37,231,194,2023,"MISSOURI"
"1354","WASHINGTON, UNIVERSITY OF",78,70,0,28,148,120,2023,"WASHINGTON"
"1355","WAYNE STATE UNIVERSITY",59,56,0,17,115,98,2023,"MICHIGAN"
"1356","WEST VIRGINIA UNIVERSITY",36,33,0,7,69,62,2023,"WEST VIRGINIA"
"1357","WESTERN NEW ENGLAND UNIVERSITY",41,53,0,15,95,80,2023,"MASSACHUSETTS"
"1358","WESTERN STATE COLLEGE OF LAW",30,23,0,13,53,40,2023,"CALIFORNIA"
"1359","WIDENER-COMMONWEALTH",35,32,0,4,67,63,2023,"PENNSYLVANIA"
"1360","WIDENER UNIVERSITY-DELAWARE",41,48,0,10,89,79,2023,"DELAWARE"
"1361","WILLAMETTE UNIVERSITY",30,25,0,7,55,48,2023,"OREGON"
"1362","WILLIAM AND MARY LAW SCHOOL",94,54,0,16,148,132,2023,"VIRGINIA"
"1363","WISCONSIN, UNIVERSITY OF",77,68,0,24,145,121,2023,"WISCONSIN"
"1364","WYOMING, UNIVERSITY OF",21,16,0,8,37,29,2023,"WYOMING"
"1365","YALE UNIVERSITY",164,98,1,39,263,224,2023,"CONNECTICUT"
